A00001,1,1,0,2,0.5,0.5,0.0
A00002,1,1,0,2,0.5,0.5,0.0
A00013,0,1,0,1,0.0,1.0,0.0
A00016,0,1,0,1,0.0,1.0,0.0
A00022,0,2,0,2,0.0,1.0,0.0
A00051,0,1,0,1,0.0,1.0,0.0
A00076,0,1,0,1,0.0,1.0,0.0
A00077,1,0,0,1,1.0,0.0,0.0
A00079,1,0,0,1,1.0,0.0,0.0
A00094,1,0,0,1,1.0,0.0,0.0
A00095,0,1,0,1,0.0,1.0,0.0
A00096,1,0,0,1,1.0,0.0,0.0
A00100,5,0,0,5,1.0,0.0,0.0
A00113,6,1,0,7,0.86,0.14,0.0
A00118,1,1,0,2,0.5,0.5,0.0
A00121,1,0,0,1,1.0,0.0,0.0
A00125,0,1,0,1,0.0,1.0,0.0
A00126,1,0,0,1,1.0,0.0,0.0
A00128,4,0,0,4,1.0,0.0,0.0
A00145,6,0,0,6,1.0,0.0,0.0
A00152,0,1,0,1,0.0,1.0,0.0
A00163,1,0,0,1,1.0,0.0,0.0
A00164,5,0,0,5,1.0,0.0,0.0
A00172,1,0,0,1,1.0,0.0,0.0
A00178,7,0,0,7,1.0,0.0,0.0
A00187,0,1,0,1,0.0,1.0,0.0
A00192,5,0,0,5,1.0,0.0,0.0
A00202,1,1,0,2,0.5,0.5,0.0
A00264,2,0,0,2,1.0,0.0,0.0
A00279,2,0,0,2,1.0,0.0,0.0
A00293,3,0,0,3,1.0,0.0,0.0
A00303,1,0,0,1,1.0,0.0,0.0
A00324,1,0,0,1,1.0,0.0,0.0
A00339,2,0,0,2,1.0,0.0,0.0
A00372,1,0,0,1,1.0,0.0,0.0
A00373,1,0,0,1,1.0,0.0,0.0
A00387,1,0,0,1,1.0,0.0,0.0
A00404,2,0,0,2,1.0,0.0,0.0
A00418,3,0,0,3,1.0,0.0,0.0
A00427,1,0,0,1,1.0,0.0,0.0
A00451,1,0,0,1,1.0,0.0,0.0
A00452,1,0,0,1,1.0,0.0,0.0
A00454,5,0,0,5,1.0,0.0,0.0
A00472,9,0,0,9,1.0,0.0,0.0
A00474,3,0,0,3,1.0,0.0,0.0
A00482,2,0,0,2,1.0,0.0,0.0
A00494,8,0,0,8,1.0,0.0,0.0
A00496,1,0,0,1,1.0,0.0,0.0
A00497,1,0,0,1,1.0,0.0,0.0
A00505,1,0,0,1,1.0,0.0,0.0
A00506,5,0,0,5,1.0,0.0,0.0
A00514,3,0,0,3,1.0,0.0,0.0
A00526,2,0,0,2,1.0,0.0,0.0
A00527,1,0,0,1,1.0,0.0,0.0
A00532,10,0,0,10,1.0,0.0,0.0
A00538,2,0,0,2,1.0,0.0,0.0
A00544,9,0,0,9,1.0,0.0,0.0
A00546,3,0,0,3,1.0,0.0,0.0
A00559,1,0,0,1,1.0,0.0,0.0
A00567,2,0,0,2,1.0,0.0,0.0
A00568,2,0,0,2,1.0,0.0,0.0
A00578,3,0,0,3,1.0,0.0,0.0
A00582,1,0,0,1,1.0,0.0,0.0
A00583,2,0,0,2,1.0,0.0,0.0
A00601,8,0,0,8,1.0,0.0,0.0
A00603,3,0,0,3,1.0,0.0,0.0
A00625,3,0,0,3,1.0,0.0,0.0
A00626,3,0,0,3,1.0,0.0,0.0
A00627,3,0,0,3,1.0,0.0,0.0
A00639,1,0,0,1,1.0,0.0,0.0
A00640,1,0,0,1,1.0,0.0,0.0
A00649,1,0,0,1,1.0,0.0,0.0
A00650,1,0,0,1,1.0,0.0,0.0
A00651,1,0,0,1,1.0,0.0,0.0
A00656,2,0,0,2,1.0,0.0,0.0
A00659,1,0,0,1,1.0,0.0,0.0
A00660,1,0,0,1,1.0,0.0,0.0
A00665,7,0,0,7,1.0,0.0,0.0
A00670,1,0,0,1,1.0,0.0,0.0
A00678,1,0,0,1,1.0,0.0,0.0
A00699,2,0,0,2,1.0,0.0,0.0
A00704,3,0,0,3,1.0,0.0,0.0
A00709,1,0,0,1,1.0,0.0,0.0
A00710,2,0,0,2,1.0,0.0,0.0
A00724,1,0,0,1,1.0,0.0,0.0
A00736,3,0,0,3,1.0,0.0,0.0
A00752,1,0,0,1,1.0,0.0,0.0
A00754,1,0,0,1,1.0,0.0,0.0
A00758,7,0,0,7,1.0,0.0,0.0
A00759,7,0,0,7,1.0,0.0,0.0
A00763,1,0,0,1,1.0,0.0,0.0
A00770,2,0,0,2,1.0,0.0,0.0
A00771,9,0,0,9,1.0,0.0,0.0
A00777,2,0,0,2,1.0,0.0,0.0
A00781,1,0,0,1,1.0,0.0,0.0
A00792,5,0,0,5,1.0,0.0,0.0
A00799,3,0,0,3,1.0,0.0,0.0
A00806,1,0,0,1,1.0,0.0,0.0
A00836,1,0,0,1,1.0,0.0,0.0
A00838,3,0,0,3,1.0,0.0,0.0
A00841,1,0,0,1,1.0,0.0,0.0
A00855,1,0,0,1,1.0,0.0,0.0
A00856,16,0,0,16,1.0,0.0,0.0
A00857,16,0,0,16,1.0,0.0,0.0
A00865,1,0,0,1,1.0,0.0,0.0
A00869,3,0,0,3,1.0,0.0,0.0
A00874,1,0,0,1,1.0,0.0,0.0
A00882,1,0,0,1,1.0,0.0,0.0
A00888,1,0,0,1,1.0,0.0,0.0
A00889,3,0,0,3,1.0,0.0,0.0
A00894,1,0,0,1,1.0,0.0,0.0
A00899,1,0,0,1,1.0,0.0,0.0
A00922,2,0,0,2,1.0,0.0,0.0
A00927,8,0,0,8,1.0,0.0,0.0
A00928,1,0,0,1,1.0,0.0,0.0
A00929,1,0,0,1,1.0,0.0,0.0
A00933,1,0,0,1,1.0,0.0,0.0
A00940,2,0,0,2,1.0,0.0,0.0
A00944,2,0,0,2,1.0,0.0,0.0
A00958,2,0,0,2,1.0,0.0,0.0
A00960,1,0,0,1,1.0,0.0,0.0
A00961,2,0,0,2,1.0,0.0,0.0
A00968,12,0,0,12,1.0,0.0,0.0
A00969,1,0,0,1,1.0,0.0,0.0
A00980,3,0,0,3,1.0,0.0,0.0
A00986,1,0,0,1,1.0,0.0,0.0
A00987,4,0,0,4,1.0,0.0,0.0
A00991,1,0,0,1,1.0,0.0,0.0
A00999,7,0,0,7,1.0,0.0,0.0
A01005,1,0,0,1,1.0,0.0,0.0
A01011,2,0,0,2,1.0,0.0,0.0
A01019,1,0,0,1,1.0,0.0,0.0
A01027,2,0,0,2,1.0,0.0,0.0
A01029,6,0,0,6,1.0,0.0,0.0
A01033,11,0,0,11,1.0,0.0,0.0
A01036,1,0,0,1,1.0,0.0,0.0
A01039,0,1,0,1,0.0,1.0,0.0
A01040,15,0,0,15,1.0,0.0,0.0
A01044,3,0,0,3,1.0,0.0,0.0
A01047,8,0,0,8,1.0,0.0,0.0
A01067,1,0,0,1,1.0,0.0,0.0
A01072,1,0,0,1,1.0,0.0,0.0
A01100,1,0,0,1,1.0,0.0,0.0
A01111,1,0,0,1,1.0,0.0,0.0
A01121,1,0,0,1,1.0,0.0,0.0
A01133,1,0,0,1,1.0,0.0,0.0
A01137,6,0,0,6,1.0,0.0,0.0
A01147,10,0,0,10,1.0,0.0,0.0
A01154,11,1,0,12,0.92,0.08,0.0
A01155,6,0,0,6,1.0,0.0,0.0
A01160,6,0,0,6,1.0,0.0,0.0
A01161,1,0,0,1,1.0,0.0,0.0
A01162,1,0,0,1,1.0,0.0,0.0
A01166,3,0,0,3,1.0,0.0,0.0
A01169,9,0,0,9,1.0,0.0,0.0
A01181,7,0,0,7,1.0,0.0,0.0
A01182,2,0,0,2,1.0,0.0,0.0
A01186,6,0,0,6,1.0,0.0,0.0
A01187,4,0,0,4,1.0,0.0,0.0
A01188,4,0,0,4,1.0,0.0,0.0
A01189,1,0,0,1,1.0,0.0,0.0
A01192,2,0,0,2,1.0,0.0,0.0
A01193,2,0,0,2,1.0,0.0,0.0
A01195,3,0,0,3,1.0,0.0,0.0
A01197,2,0,0,2,1.0,0.0,0.0
A01202,3,0,0,3,1.0,0.0,0.0
A01204,7,0,0,7,1.0,0.0,0.0
A01206,1,0,0,1,1.0,0.0,0.0
A01211,2,0,0,2,1.0,0.0,0.0
A01215,30,0,0,30,1.0,0.0,0.0
A01216,7,0,0,7,1.0,0.0,0.0
A01219,3,0,0,3,1.0,0.0,0.0
A01224,4,0,0,4,1.0,0.0,0.0
A01226,7,0,0,7,1.0,0.0,0.0
A01233,1,0,0,1,1.0,0.0,0.0
A01234,1,0,0,1,1.0,0.0,0.0
A01239,2,0,0,2,1.0,0.0,0.0
A01241,1,0,0,1,1.0,0.0,0.0
A01244,1,0,0,1,1.0,0.0,0.0
A01247,3,0,0,3,1.0,0.0,0.0
A01253,7,0,0,7,1.0,0.0,0.0
A01255,2,0,0,2,1.0,0.0,0.0
A01263,9,0,0,9,1.0,0.0,0.0
A01268,2,0,0,2,1.0,0.0,0.0
A01283,0,1,0,1,0.0,1.0,0.0
A01295,0,1,0,1,0.0,1.0,0.0
A01305,3,0,0,3,1.0,0.0,0.0
A01306,3,0,0,3,1.0,0.0,0.0
A01317,2,0,0,2,1.0,0.0,0.0
A01322,2,0,0,2,1.0,0.0,0.0
A01331,3,0,0,3,1.0,0.0,0.0
A01333,1,0,0,1,1.0,0.0,0.0
A01335,1,0,0,1,1.0,0.0,0.0
A01339,31,0,0,31,1.0,0.0,0.0
A01341,5,0,0,5,1.0,0.0,0.0
A01343,2,0,0,2,1.0,0.0,0.0
A01344,17,0,0,17,1.0,0.0,0.0
A01349,3,0,0,3,1.0,0.0,0.0
A01350,1,0,0,1,1.0,0.0,0.0
A01353,1,0,0,1,1.0,0.0,0.0
A01355,1,0,0,1,1.0,0.0,0.0
A01356,2,0,0,2,1.0,0.0,0.0
A01358,3,0,0,3,1.0,0.0,0.0
A01361,5,0,0,5,1.0,0.0,0.0
A01362,1,0,0,1,1.0,0.0,0.0
A01364,2,0,0,2,1.0,0.0,0.0
A01378,2,0,0,2,1.0,0.0,0.0
A01382,5,0,0,5,1.0,0.0,0.0
A01383,3,0,1,4,0.75,0.0,0.25
A01390,3,0,0,3,1.0,0.0,0.0
A01391,3,0,0,3,1.0,0.0,0.0
A01404,4,0,0,4,1.0,0.0,0.0
A01405,1,0,0,1,1.0,0.0,0.0
A01414,2,0,0,2,1.0,0.0,0.0
A01415,1,0,0,1,1.0,0.0,0.0
A01422,1,0,0,1,1.0,0.0,0.0
A01430,1,0,0,1,1.0,0.0,0.0
A01443,1,0,0,1,1.0,0.0,0.0
A01445,1,0,0,1,1.0,0.0,0.0
A01451,1,0,0,1,1.0,0.0,0.0
A01454,1,0,0,1,1.0,0.0,0.0
A01458,1,0,0,1,1.0,0.0,0.0
A01462,1,0,0,1,1.0,0.0,0.0
A01466,1,0,0,1,1.0,0.0,0.0
A01467,4,0,0,4,1.0,0.0,0.0
A01470,1,0,0,1,1.0,0.0,0.0
A01472,1,0,0,1,1.0,0.0,0.0
A01473,2,0,0,2,1.0,0.0,0.0
A01479,2,0,0,2,1.0,0.0,0.0
A01482,7,0,0,7,1.0,0.0,0.0
A01484,1,0,0,1,1.0,0.0,0.0
A01485,1,0,0,1,1.0,0.0,0.0
A01487,2,0,0,2,1.0,0.0,0.0
A01494,6,0,0,6,1.0,0.0,0.0
A01496,3,0,0,3,1.0,0.0,0.0
A01497,3,0,0,3,1.0,0.0,0.0
A01498,3,0,0,3,1.0,0.0,0.0
A01499,8,0,0,8,1.0,0.0,0.0
A01500,8,0,0,8,1.0,0.0,0.0
A01501,1,0,0,1,1.0,0.0,0.0
A01516,2,0,0,2,1.0,0.0,0.0
A01520,1,0,0,1,1.0,0.0,0.0
A01525,2,0,0,2,1.0,0.0,0.0
A01528,1,0,0,1,1.0,0.0,0.0
A01542,5,0,0,5,1.0,0.0,0.0
A01543,5,0,0,5,1.0,0.0,0.0
A01544,5,0,0,5,1.0,0.0,0.0
A01547,1,0,0,1,1.0,0.0,0.0
A01553,1,0,0,1,1.0,0.0,0.0
A01554,4,0,0,4,1.0,0.0,0.0
A01557,3,0,0,3,1.0,0.0,0.0
A01559,3,0,0,3,1.0,0.0,0.0
A01561,3,0,0,3,1.0,0.0,0.0
A01565,1,0,0,1,1.0,0.0,0.0
A01570,4,0,0,4,1.0,0.0,0.0
A01572,9,0,0,9,1.0,0.0,0.0
A01576,2,0,0,2,1.0,0.0,0.0
A01579,1,0,0,1,1.0,0.0,0.0
A01581,15,0,0,15,1.0,0.0,0.0
A01582,1,0,0,1,1.0,0.0,0.0
A01585,4,0,0,4,1.0,0.0,0.0
A01588,1,0,0,1,1.0,0.0,0.0
A01601,2,0,0,2,1.0,0.0,0.0
A01606,5,0,0,5,1.0,0.0,0.0
A01608,2,0,0,2,1.0,0.0,0.0
A01611,2,0,0,2,1.0,0.0,0.0
A01615,3,0,0,3,1.0,0.0,0.0
A01616,7,0,0,7,1.0,0.0,0.0
A01618,11,0,0,11,1.0,0.0,0.0
A01619,11,0,0,11,1.0,0.0,0.0
A01622,1,0,0,1,1.0,0.0,0.0
A01642,1,0,0,1,1.0,0.0,0.0
A01646,5,0,0,5,1.0,0.0,0.0
A01648,6,0,0,6,1.0,0.0,0.0
A01650,2,0,0,2,1.0,0.0,0.0
A01656,3,0,0,3,1.0,0.0,0.0
A01659,7,0,0,7,1.0,0.0,0.0
A01662,1,0,0,1,1.0,0.0,0.0
A01669,5,0,0,5,1.0,0.0,0.0
A01670,3,0,0,3,1.0,0.0,0.0
A01671,3,0,0,3,1.0,0.0,0.0
A01673,3,0,0,3,1.0,0.0,0.0
A01676,3,0,0,3,1.0,0.0,0.0
A01677,3,0,0,3,1.0,0.0,0.0
A01682,3,0,0,3,1.0,0.0,0.0
A01683,3,0,0,3,1.0,0.0,0.0
A01684,3,0,0,3,1.0,0.0,0.0
A01689,1,0,0,1,1.0,0.0,0.0
A01692,1,0,0,1,1.0,0.0,0.0
A01696,3,0,0,3,1.0,0.0,0.0
A01697,4,0,0,4,1.0,0.0,0.0
A01700,1,0,0,1,1.0,0.0,0.0
A01703,1,0,0,1,1.0,0.0,0.0
A01706,2,0,0,2,1.0,0.0,0.0
A01710,1,0,0,1,1.0,0.0,0.0
A01713,1,0,0,1,1.0,0.0,0.0
A01719,1,0,0,1,1.0,0.0,0.0
A01722,14,0,0,14,1.0,0.0,0.0
A01723,14,0,0,14,1.0,0.0,0.0
A01738,3,0,0,3,1.0,0.0,0.0
A01741,2,0,0,2,1.0,0.0,0.0
A01747,3,0,0,3,1.0,0.0,0.0
A01748,3,0,0,3,1.0,0.0,0.0
A01753,2,0,0,2,1.0,0.0,0.0
A01754,2,0,0,2,1.0,0.0,0.0
A01756,2,0,0,2,1.0,0.0,0.0
A01763,1,0,0,1,1.0,0.0,0.0
A01766,3,0,0,3,1.0,0.0,0.0
A01767,3,0,0,3,1.0,0.0,0.0
A01770,1,0,0,1,1.0,0.0,0.0
A01772,1,0,0,1,1.0,0.0,0.0
A01777,1,0,0,1,1.0,0.0,0.0
A01779,7,0,0,7,1.0,0.0,0.0
A01789,6,0,0,6,1.0,0.0,0.0
A01790,6,0,0,6,1.0,0.0,0.0
A01796,1,0,0,1,1.0,0.0,0.0
A01803,1,0,0,1,1.0,0.0,0.0
A01804,1,0,0,1,1.0,0.0,0.0
A01815,6,0,0,6,1.0,0.0,0.0
A01820,8,0,0,8,1.0,0.0,0.0
A01834,3,0,0,3,1.0,0.0,0.0
A01837,1,0,0,1,1.0,0.0,0.0
A01841,1,0,0,1,1.0,0.0,0.0
A01843,1,0,0,1,1.0,0.0,0.0
A01847,1,0,0,1,1.0,0.0,0.0
A01848,7,0,0,7,1.0,0.0,0.0
A01852,2,0,0,2,1.0,0.0,0.0
A01856,1,0,0,1,1.0,0.0,0.0
A01859,1,0,0,1,1.0,0.0,0.0
A01863,4,0,0,4,1.0,0.0,0.0
A01869,3,0,0,3,1.0,0.0,0.0
A01876,1,0,0,1,1.0,0.0,0.0
A01882,3,0,0,3,1.0,0.0,0.0
A01888,2,0,0,2,1.0,0.0,0.0
A01890,1,0,0,1,1.0,0.0,0.0
A01892,1,0,0,1,1.0,0.0,0.0
A01912,1,0,0,1,1.0,0.0,0.0
A01929,17,0,0,17,1.0,0.0,0.0
A01932,1,0,0,1,1.0,0.0,0.0
A01942,3,0,0,3,1.0,0.0,0.0
A01951,1,0,0,1,1.0,0.0,0.0
A01971,7,0,0,7,1.0,0.0,0.0
A01973,3,0,0,3,1.0,0.0,0.0
A01974,1,0,0,1,1.0,0.0,0.0
A01981,1,0,0,1,1.0,0.0,0.0
A01986,1,0,0,1,1.0,0.0,0.0
A01996,15,0,0,15,1.0,0.0,0.0
A01997,5,0,0,5,1.0,0.0,0.0
A01999,5,0,0,5,1.0,0.0,0.0
A02002,8,0,0,8,1.0,0.0,0.0
A02003,1,0,0,1,1.0,0.0,0.0
A02004,7,0,0,7,1.0,0.0,0.0
A02013,6,0,0,6,1.0,0.0,0.0
A02014,6,0,0,6,1.0,0.0,0.0
A02016,3,0,0,3,1.0,0.0,0.0
A02023,6,0,0,6,1.0,0.0,0.0
A02028,1,0,0,1,1.0,0.0,0.0
A02037,6,0,0,6,1.0,0.0,0.0
A02042,21,0,0,21,1.0,0.0,0.0
A02044,4,0,0,4,1.0,0.0,0.0
A02045,3,0,0,3,1.0,0.0,0.0
A02046,2,0,0,2,1.0,0.0,0.0
A02047,2,0,0,2,1.0,0.0,0.0
A02048,6,0,0,6,1.0,0.0,0.0
A02049,6,0,0,6,1.0,0.0,0.0
A02050,6,0,0,6,1.0,0.0,0.0
A02054,7,0,0,7,1.0,0.0,0.0
A02056,4,0,0,4,1.0,0.0,0.0
A02057,4,0,0,4,1.0,0.0,0.0
A02058,15,0,0,15,1.0,0.0,0.0
A02059,15,0,0,15,1.0,0.0,0.0
A02061,1,0,0,1,1.0,0.0,0.0
A02062,1,0,0,1,1.0,0.0,0.0
A02063,1,0,0,1,1.0,0.0,0.0
A02064,3,0,0,3,1.0,0.0,0.0
A02066,4,0,0,4,1.0,0.0,0.0
A02067,16,0,0,16,1.0,0.0,0.0
A02068,3,0,0,3,1.0,0.0,0.0
A02069,2,0,0,2,1.0,0.0,0.0
A02074,1,0,0,1,1.0,0.0,0.0
A02077,3,0,0,3,1.0,0.0,0.0
A02078,6,0,0,6,1.0,0.0,0.0
A02081,3,0,0,3,1.0,0.0,0.0
A02082,2,0,0,2,1.0,0.0,0.0
A02084,2,0,0,2,1.0,0.0,0.0
A02087,3,0,0,3,1.0,0.0,0.0
A02088,1,0,0,1,1.0,0.0,0.0
A02092,15,0,0,15,1.0,0.0,0.0
A02094,3,0,0,3,1.0,0.0,0.0
A02095,6,0,0,6,1.0,0.0,0.0
A02096,6,0,0,6,1.0,0.0,0.0
A02098,1,0,0,1,1.0,0.0,0.0
A02099,1,0,0,1,1.0,0.0,0.0
A02101,1,0,0,1,1.0,0.0,0.0
A02104,1,0,0,1,1.0,0.0,0.0
A02116,1,0,0,1,1.0,0.0,0.0
A02118,2,0,0,2,1.0,0.0,0.0
A02119,1,0,0,1,1.0,0.0,0.0
A02120,2,0,0,2,1.0,0.0,0.0
A02123,4,0,0,4,1.0,0.0,0.0
A02131,1,0,0,1,1.0,0.0,0.0
A02134,1,0,0,1,1.0,0.0,0.0
A02137,2,0,0,2,1.0,0.0,0.0
A02138,2,0,0,2,1.0,0.0,0.0
A02140,3,0,0,3,1.0,0.0,0.0
A02142,1,0,0,1,1.0,0.0,0.0
A02146,2,0,0,2,1.0,0.0,0.0
A02148,1,0,0,1,1.0,0.0,0.0
A02162,1,0,0,1,1.0,0.0,0.0
A02164,2,0,0,2,1.0,0.0,0.0
A02168,7,0,0,7,1.0,0.0,0.0
A02169,3,0,0,3,1.0,0.0,0.0
A02172,7,0,0,7,1.0,0.0,0.0
A02173,3,0,0,3,1.0,0.0,0.0
A02178,0,0,1,1,0.0,0.0,1.0
A02179,13,0,0,13,1.0,0.0,0.0
A02181,1,0,0,1,1.0,0.0,0.0
A02182,2,0,0,2,1.0,0.0,0.0
A02183,5,0,0,5,1.0,0.0,0.0
A02184,1,0,0,1,1.0,0.0,0.0
A02186,2,0,0,2,1.0,0.0,0.0
A02188,4,0,0,4,1.0,0.0,0.0
A02189,1,0,0,1,1.0,0.0,0.0
A02190,3,0,0,3,1.0,0.0,0.0
A02191,3,0,0,3,1.0,0.0,0.0
A02192,2,0,0,2,1.0,0.0,0.0
A02193,3,0,0,3,1.0,0.0,0.0
A02196,2,0,0,2,1.0,0.0,0.0
A02198,1,0,0,1,1.0,0.0,0.0
A02203,3,0,0,3,1.0,0.0,0.0
A02205,1,0,0,1,1.0,0.0,0.0
A02208,9,0,0,9,1.0,0.0,0.0
A02210,3,0,0,3,1.0,0.0,0.0
A02211,1,0,0,1,1.0,0.0,0.0
A02218,1,0,0,1,1.0,0.0,0.0
A02223,3,0,0,3,1.0,0.0,0.0
A02224,3,0,0,3,1.0,0.0,0.0
A02226,5,0,0,5,1.0,0.0,0.0
A02228,7,0,0,7,1.0,0.0,0.0
A02230,5,0,0,5,1.0,0.0,0.0
A02231,1,0,0,1,1.0,0.0,0.0
A02234,5,0,0,5,1.0,0.0,0.0
A02237,2,0,0,2,1.0,0.0,0.0
A02238,3,0,0,3,1.0,0.0,0.0
A02239,2,0,0,2,1.0,0.0,0.0
A02240,7,0,0,7,1.0,0.0,0.0
A02241,4,0,0,4,1.0,0.0,0.0
A02243,1,0,0,1,1.0,0.0,0.0
A02251,2,0,0,2,1.0,0.0,0.0
A02252,2,0,0,2,1.0,0.0,0.0
A02253,2,0,0,2,1.0,0.0,0.0
A02254,1,0,0,1,1.0,0.0,0.0
A02261,2,0,0,2,1.0,0.0,0.0
A02268,4,0,0,4,1.0,0.0,0.0
A02271,3,0,0,3,1.0,0.0,0.0
A02278,3,0,0,3,1.0,0.0,0.0
A02286,2,0,0,2,1.0,0.0,0.0
A02291,1,0,0,1,1.0,0.0,0.0
A02292,4,0,0,4,1.0,0.0,0.0
A02293,1,0,0,1,1.0,0.0,0.0
A02294,1,0,0,1,1.0,0.0,0.0
A02297,1,0,0,1,1.0,0.0,0.0
A02298,11,0,0,11,1.0,0.0,0.0
A02302,3,0,0,3,1.0,0.0,0.0
A02303,9,0,0,9,1.0,0.0,0.0
A02305,5,0,0,5,1.0,0.0,0.0
A02311,1,0,0,1,1.0,0.0,0.0
A02312,1,0,0,1,1.0,0.0,0.0
A02315,1,0,0,1,1.0,0.0,0.0
A02316,1,0,0,1,1.0,0.0,0.0
A02325,3,0,0,3,1.0,0.0,0.0
A02329,4,0,0,4,1.0,0.0,0.0
A02330,4,0,0,4,1.0,0.0,0.0
A02331,1,0,0,1,1.0,0.0,0.0
A02336,4,0,0,4,1.0,0.0,0.0
A02342,1,0,0,1,1.0,0.0,0.0
A02343,1,0,0,1,1.0,0.0,0.0
A02346,3,0,0,3,1.0,0.0,0.0
A02348,2,0,0,2,1.0,0.0,0.0
A02351,8,0,0,8,1.0,0.0,0.0
A02352,1,0,0,1,1.0,0.0,0.0
A02353,2,0,0,2,1.0,0.0,0.0
A02354,2,0,0,2,1.0,0.0,0.0
A02355,3,0,0,3,1.0,0.0,0.0
A02356,1,0,0,1,1.0,0.0,0.0
A02359,1,0,0,1,1.0,0.0,0.0
A02362,4,0,0,4,1.0,0.0,0.0
A02363,4,0,0,4,1.0,0.0,0.0
A02366,3,0,0,3,1.0,0.0,0.0
A02369,4,0,0,4,1.0,0.0,0.0
A02376,2,0,0,2,1.0,0.0,0.0
A02377,1,0,0,1,1.0,0.0,0.0
A02379,2,0,0,2,1.0,0.0,0.0
A02382,1,0,0,1,1.0,0.0,0.0
A02383,6,0,0,6,1.0,0.0,0.0
A02384,17,0,0,17,1.0,0.0,0.0
A02385,17,0,0,17,1.0,0.0,0.0
A02387,3,0,0,3,1.0,0.0,0.0
A02388,4,0,0,4,1.0,0.0,0.0
A02389,7,0,0,7,1.0,0.0,0.0
A02391,2,0,0,2,1.0,0.0,0.0
A02393,2,0,0,2,1.0,0.0,0.0
A02394,8,0,0,8,1.0,0.0,0.0
A02395,2,0,0,2,1.0,0.0,0.0
A02397,1,0,0,1,1.0,0.0,0.0
A02398,1,0,0,1,1.0,0.0,0.0
A02401,4,0,0,4,1.0,0.0,0.0
A02402,7,0,0,7,1.0,0.0,0.0
A02403,1,0,0,1,1.0,0.0,0.0
A02404,3,0,0,3,1.0,0.0,0.0
A02405,5,0,0,5,1.0,0.0,0.0
A02407,3,1,0,4,0.75,0.25,0.0
A02411,1,0,0,1,1.0,0.0,0.0
A02415,6,0,0,6,1.0,0.0,0.0
A02416,1,0,0,1,1.0,0.0,0.0
A02417,8,0,0,8,1.0,0.0,0.0
A02418,2,0,0,2,1.0,0.0,0.0
A02420,3,0,0,3,1.0,0.0,0.0
A02422,1,0,0,1,1.0,0.0,0.0
A02423,2,0,0,2,1.0,0.0,0.0
A02424,3,0,0,3,1.0,0.0,0.0
A02425,3,0,0,3,1.0,0.0,0.0
A02428,6,0,0,6,1.0,0.0,0.0
A02429,19,1,0,20,0.95,0.05,0.0
A02430,6,0,0,6,1.0,0.0,0.0
A02431,2,0,0,2,1.0,0.0,0.0
A02432,1,0,0,1,1.0,0.0,0.0
A02434,3,0,0,3,1.0,0.0,0.0
A02436,2,0,0,2,1.0,0.0,0.0
A02439,4,0,0,4,1.0,0.0,0.0
A02440,1,0,0,1,1.0,0.0,0.0
A02441,5,0,0,5,1.0,0.0,0.0
A02442,4,0,0,4,1.0,0.0,0.0
A02443,1,0,0,1,1.0,0.0,0.0
A02445,2,0,0,2,1.0,0.0,0.0
A02451,1,0,0,1,1.0,0.0,0.0
A02452,9,0,0,9,1.0,0.0,0.0
A02453,2,0,0,2,1.0,0.0,0.0
A02454,1,0,0,1,1.0,0.0,0.0
A02458,9,0,0,9,1.0,0.0,0.0
A02459,3,0,0,3,1.0,0.0,0.0
A02460,2,0,0,2,1.0,0.0,0.0
A02462,1,0,0,1,1.0,0.0,0.0
A02463,2,0,0,2,1.0,0.0,0.0
A02466,1,0,0,1,1.0,0.0,0.0
A02467,4,0,0,4,1.0,0.0,0.0
A02468,2,0,0,2,1.0,0.0,0.0
A02472,12,0,0,12,1.0,0.0,0.0
A02473,3,0,0,3,1.0,0.0,0.0
A02474,1,0,0,1,1.0,0.0,0.0
A02476,10,0,0,10,1.0,0.0,0.0
A02477,8,0,0,8,1.0,0.0,0.0
A02478,3,0,0,3,1.0,0.0,0.0
A02479,5,0,0,5,1.0,0.0,0.0
A02480,5,0,0,5,1.0,0.0,0.0
A02481,4,0,0,4,1.0,0.0,0.0
A02482,5,0,0,5,1.0,0.0,0.0
A02484,3,0,0,3,1.0,0.0,0.0
A02485,4,0,0,4,1.0,0.0,0.0
A02489,7,0,0,7,1.0,0.0,0.0
A02490,3,0,0,3,1.0,0.0,0.0
A02491,7,0,0,7,1.0,0.0,0.0
A02494,4,0,0,4,1.0,0.0,0.0
A02495,12,0,0,12,1.0,0.0,0.0
A02496,3,0,0,3,1.0,0.0,0.0
A02498,2,0,0,2,1.0,0.0,0.0
A02499,3,0,0,3,1.0,0.0,0.0
A02500,19,0,0,19,1.0,0.0,0.0
A02502,3,0,0,3,1.0,0.0,0.0
A02504,4,0,0,4,1.0,0.0,0.0
A02509,1,0,0,1,1.0,0.0,0.0
A02510,5,0,0,5,1.0,0.0,0.0
A02511,9,0,0,9,1.0,0.0,0.0
A02512,3,0,0,3,1.0,0.0,0.0
A02513,1,0,0,1,1.0,0.0,0.0
A02515,2,0,0,2,1.0,0.0,0.0
A02519,9,0,0,9,1.0,0.0,0.0
A02521,1,0,0,1,1.0,0.0,0.0
A02522,1,0,0,1,1.0,0.0,0.0
A02523,3,0,0,3,1.0,0.0,0.0
A02524,6,0,0,6,1.0,0.0,0.0
A02527,1,0,0,1,1.0,0.0,0.0
A02528,2,0,0,2,1.0,0.0,0.0
A02531,1,0,0,1,1.0,0.0,0.0
A02533,8,0,0,8,1.0,0.0,0.0
A02534,11,0,0,11,1.0,0.0,0.0
A02540,1,0,0,1,1.0,0.0,0.0
A02542,10,0,0,10,1.0,0.0,0.0
A02543,6,0,0,6,1.0,0.0,0.0
A02544,5,0,0,5,1.0,0.0,0.0
A02545,3,0,0,3,1.0,0.0,0.0
A02548,1,0,0,1,1.0,0.0,0.0
A02549,5,0,0,5,1.0,0.0,0.0
A02552,3,0,0,3,1.0,0.0,0.0
A02554,2,0,0,2,1.0,0.0,0.0
A02556,6,0,0,6,1.0,0.0,0.0
A02557,1,0,0,1,1.0,0.0,0.0
A02559,6,0,0,6,1.0,0.0,0.0
A02560,5,0,0,5,1.0,0.0,0.0
A02561,1,0,0,1,1.0,0.0,0.0
A02564,1,0,0,1,1.0,0.0,0.0
A02565,1,0,0,1,1.0,0.0,0.0
A02566,10,0,0,10,1.0,0.0,0.0
A02567,1,0,0,1,1.0,0.0,0.0
A02568,3,0,0,3,1.0,0.0,0.0
A02573,6,0,0,6,1.0,0.0,0.0
A02574,3,0,0,3,1.0,0.0,0.0
A02575,1,0,0,1,1.0,0.0,0.0
A02577,9,0,0,9,1.0,0.0,0.0
A02580,6,0,0,6,1.0,0.0,0.0
A02581,1,0,0,1,1.0,0.0,0.0
A02582,5,0,0,5,1.0,0.0,0.0
A02584,7,0,0,7,1.0,0.0,0.0
A02585,3,0,0,3,1.0,0.0,0.0
A02586,1,0,0,1,1.0,0.0,0.0
A02587,3,0,0,3,1.0,0.0,0.0
A02588,3,0,0,3,1.0,0.0,0.0
A02589,5,0,0,5,1.0,0.0,0.0
A02590,1,0,0,1,1.0,0.0,0.0
A02591,2,0,0,2,1.0,0.0,0.0
A02595,1,0,0,1,1.0,0.0,0.0
A02596,3,0,0,3,1.0,0.0,0.0
A02597,3,0,0,3,1.0,0.0,0.0
A02598,4,0,0,4,1.0,0.0,0.0
A02600,6,1,0,7,0.86,0.14,0.0
A02603,2,0,0,2,1.0,0.0,0.0
A02607,2,0,0,2,1.0,0.0,0.0
A02612,2,0,0,2,1.0,0.0,0.0
A02617,2,0,0,2,1.0,0.0,0.0
A02628,4,0,0,4,1.0,0.0,0.0
A02629,4,0,0,4,1.0,0.0,0.0
A02630,3,0,0,3,1.0,0.0,0.0
A02632,2,0,0,2,1.0,0.0,0.0
A02634,15,0,0,15,1.0,0.0,0.0
A02644,1,0,0,1,1.0,0.0,0.0
A02645,5,0,0,5,1.0,0.0,0.0
A02648,7,0,0,7,1.0,0.0,0.0
A02652,1,0,0,1,1.0,0.0,0.0
A02654,1,0,0,1,1.0,0.0,0.0
A02655,1,0,0,1,1.0,0.0,0.0
A02660,0,1,0,1,0.0,1.0,0.0
A02663,5,1,0,6,0.83,0.17,0.0
A02671,1,0,0,1,1.0,0.0,0.0
A02672,1,0,0,1,1.0,0.0,0.0
A02673,4,0,0,4,1.0,0.0,0.0
A02674,8,0,0,8,1.0,0.0,0.0
A02675,2,0,0,2,1.0,0.0,0.0
A02698,8,0,0,8,1.0,0.0,0.0
A02700,3,0,0,3,1.0,0.0,0.0
A02703,4,0,0,4,1.0,0.0,0.0
A02705,2,0,0,2,1.0,0.0,0.0
A02707,7,0,0,7,1.0,0.0,0.0
A02709,1,0,0,1,1.0,0.0,0.0
A02710,2,0,0,2,1.0,0.0,0.0
A02711,1,0,0,1,1.0,0.0,0.0
A02712,1,0,0,1,1.0,0.0,0.0
A02715,2,0,0,2,1.0,0.0,0.0
A02716,0,1,0,1,0.0,1.0,0.0
A02717,3,0,0,3,1.0,0.0,0.0
A02718,4,0,0,4,1.0,0.0,0.0
A02722,2,0,0,2,1.0,0.0,0.0
A02723,7,0,0,7,1.0,0.0,0.0
A02726,4,0,0,4,1.0,0.0,0.0
A02727,5,0,0,5,1.0,0.0,0.0
A02728,14,0,0,14,1.0,0.0,0.0
A02731,4,0,0,4,1.0,0.0,0.0
A02732,2,0,0,2,1.0,0.0,0.0
A02736,2,0,0,2,1.0,0.0,0.0
A02738,11,0,0,11,1.0,0.0,0.0
A02741,1,0,0,1,1.0,0.0,0.0
A02744,1,0,0,1,1.0,0.0,0.0
A02745,2,0,0,2,1.0,0.0,0.0
A02749,2,0,0,2,1.0,0.0,0.0
A02750,1,0,0,1,1.0,0.0,0.0
A02754,6,0,0,6,1.0,0.0,0.0
A02755,4,0,0,4,1.0,0.0,0.0
A02757,3,0,0,3,1.0,0.0,0.0
A02759,3,0,0,3,1.0,0.0,0.0
A02760,13,0,0,13,1.0,0.0,0.0
A02761,1,0,0,1,1.0,0.0,0.0
A02762,9,0,0,9,1.0,0.0,0.0
A02763,6,0,0,6,1.0,0.0,0.0
A02764,12,0,0,12,1.0,0.0,0.0
A02765,3,0,0,3,1.0,0.0,0.0
A02766,10,0,0,10,1.0,0.0,0.0
A02767,11,0,0,11,1.0,0.0,0.0
A02769,12,0,0,12,1.0,0.0,0.0
A02770,3,0,0,3,1.0,0.0,0.0
A02772,1,0,0,1,1.0,0.0,0.0
A02774,1,0,0,1,1.0,0.0,0.0
A02775,9,0,0,9,1.0,0.0,0.0
A02776,4,0,0,4,1.0,0.0,0.0
A02777,4,0,0,4,1.0,0.0,0.0
A02779,1,0,0,1,1.0,0.0,0.0
A02781,17,0,0,17,1.0,0.0,0.0
A02782,1,0,0,1,1.0,0.0,0.0
A02789,4,1,0,5,0.8,0.2,0.0
A02790,19,0,0,19,1.0,0.0,0.0
A02791,5,0,0,5,1.0,0.0,0.0
A02797,3,0,0,3,1.0,0.0,0.0
A02798,4,0,0,4,1.0,0.0,0.0
A02802,3,0,0,3,1.0,0.0,0.0
A02803,9,0,0,9,1.0,0.0,0.0
A02804,2,0,0,2,1.0,0.0,0.0
A02805,7,0,0,7,1.0,0.0,0.0
A02807,5,0,0,5,1.0,0.0,0.0
A02808,2,0,0,2,1.0,0.0,0.0
A02809,2,0,0,2,1.0,0.0,0.0
A02810,1,0,0,1,1.0,0.0,0.0
A02811,3,0,0,3,1.0,0.0,0.0
A02812,1,0,0,1,1.0,0.0,0.0
A02813,11,0,0,11,1.0,0.0,0.0
A02814,3,0,0,3,1.0,0.0,0.0
A02815,7,0,0,7,1.0,0.0,0.0
A02817,9,0,0,9,1.0,0.0,0.0
A02818,4,0,0,4,1.0,0.0,0.0
A02819,5,0,0,5,1.0,0.0,0.0
A02820,1,0,0,1,1.0,0.0,0.0
A02821,2,0,0,2,1.0,0.0,0.0
A02823,7,0,0,7,1.0,0.0,0.0
A02824,2,0,0,2,1.0,0.0,0.0
A02826,5,0,0,5,1.0,0.0,0.0
A02827,22,0,0,22,1.0,0.0,0.0
A02828,10,0,0,10,1.0,0.0,0.0
A02829,6,0,0,6,1.0,0.0,0.0
A02830,4,0,0,4,1.0,0.0,0.0
A02831,3,0,0,3,1.0,0.0,0.0
A02832,1,0,0,1,1.0,0.0,0.0
A02834,2,0,0,2,1.0,0.0,0.0
A02835,3,0,0,3,1.0,0.0,0.0
A02836,1,0,0,1,1.0,0.0,0.0
A02838,5,0,0,5,1.0,0.0,0.0
A02839,13,0,0,13,1.0,0.0,0.0
A02842,3,0,0,3,1.0,0.0,0.0
A02843,13,0,0,13,1.0,0.0,0.0
A02845,6,0,0,6,1.0,0.0,0.0
A02847,2,0,0,2,1.0,0.0,0.0
A02848,1,0,0,1,1.0,0.0,0.0
A02851,6,0,0,6,1.0,0.0,0.0
A02852,4,0,0,4,1.0,0.0,0.0
A02854,9,0,0,9,1.0,0.0,0.0
A02855,11,0,0,11,1.0,0.0,0.0
A02856,3,0,0,3,1.0,0.0,0.0
A02857,1,0,0,1,1.0,0.0,0.0
A02858,7,0,0,7,1.0,0.0,0.0
A02859,10,0,0,10,1.0,0.0,0.0
A02860,5,0,0,5,1.0,0.0,0.0
A02861,1,0,0,1,1.0,0.0,0.0
A02862,2,0,0,2,1.0,0.0,0.0
A02863,6,0,0,6,1.0,0.0,0.0
A02864,2,0,0,2,1.0,0.0,0.0
A02865,3,0,0,3,1.0,0.0,0.0
A02866,3,0,0,3,1.0,0.0,0.0
A02869,16,0,0,16,1.0,0.0,0.0
A02870,2,0,0,2,1.0,0.0,0.0
A02871,5,0,0,5,1.0,0.0,0.0
A02872,5,0,0,5,1.0,0.0,0.0
A02873,2,0,0,2,1.0,0.0,0.0
A02874,1,0,0,1,1.0,0.0,0.0
A02875,4,0,0,4,1.0,0.0,0.0
A02876,2,0,0,2,1.0,0.0,0.0
A02877,54,0,0,54,1.0,0.0,0.0
A02878,3,0,0,3,1.0,0.0,0.0
A02879,8,0,0,8,1.0,0.0,0.0
A02880,12,0,0,12,1.0,0.0,0.0
A02881,6,0,0,6,1.0,0.0,0.0
A02882,3,0,0,3,1.0,0.0,0.0
A02883,1,0,0,1,1.0,0.0,0.0
A02884,3,0,0,3,1.0,0.0,0.0
A02885,1,0,0,1,1.0,0.0,0.0
A02886,8,0,0,8,1.0,0.0,0.0
A02887,12,0,0,12,1.0,0.0,0.0
A02888,8,0,0,8,1.0,0.0,0.0
A02889,6,0,0,6,1.0,0.0,0.0
A02890,5,0,0,5,1.0,0.0,0.0
A02891,7,0,0,7,1.0,0.0,0.0
A02897,2,5,0,7,0.29,0.71,0.0
A02898,15,20,0,35,0.43,0.57,0.0
A02899,3,2,0,5,0.6,0.4,0.0
A02900,0,3,0,3,0.0,1.0,0.0
A02901,0,3,1,4,0.0,0.75,0.25
A02903,4,13,0,17,0.24,0.76,0.0
A02905,26,13,1,40,0.65,0.33,0.03
A02906,3,7,0,10,0.3,0.7,0.0
A02907,0,3,0,3,0.0,1.0,0.0
A02908,0,2,0,2,0.0,1.0,0.0
A02909,1,2,0,3,0.33,0.67,0.0
A02910,3,33,0,36,0.08,0.92,0.0
A02911,4,3,0,7,0.57,0.43,0.0
A02912,4,6,0,10,0.4,0.6,0.0
A02913,0,1,0,1,0.0,1.0,0.0
A02914,2,4,0,6,0.33,0.67,0.0
A02915,2,4,0,6,0.33,0.67,0.0
A02916,1,9,0,10,0.1,0.9,0.0
A02917,12,6,1,19,0.63,0.32,0.05
A02918,5,13,0,18,0.28,0.72,0.0
A02919,4,6,0,10,0.4,0.6,0.0
A02920,0,3,0,3,0.0,1.0,0.0
A02921,2,0,0,2,1.0,0.0,0.0
A02922,0,2,0,2,0.0,1.0,0.0
A02923,0,3,0,3,0.0,1.0,0.0
A02924,0,2,0,2,0.0,1.0,0.0
A02925,1,10,0,11,0.09,0.91,0.0
A02926,0,4,0,4,0.0,1.0,0.0
A02927,22,19,0,41,0.54,0.46,0.0
A02928,3,4,0,7,0.43,0.57,0.0
A02929,1,4,0,5,0.2,0.8,0.0
A02930,2,31,0,33,0.06,0.94,0.0
A02932,0,1,0,1,0.0,1.0,0.0
A02933,1,6,0,7,0.14,0.86,0.0
A02934,12,14,0,26,0.46,0.54,0.0
A02935,0,1,0,1,0.0,1.0,0.0
A02936,0,5,0,5,0.0,1.0,0.0
A02937,0,13,0,13,0.0,1.0,0.0
A02938,0,2,0,2,0.0,1.0,0.0
A02939,5,34,0,39,0.13,0.87,0.0
A02940,0,2,0,2,0.0,1.0,0.0
A02941,1,2,0,3,0.33,0.67,0.0
A02942,1,8,0,9,0.11,0.89,0.0
A02943,0,6,0,6,0.0,1.0,0.0
A02944,1,18,0,19,0.05,0.95,0.0
A02945,2,5,0,7,0.29,0.71,0.0
A02946,1,3,0,4,0.25,0.75,0.0
A02947,0,3,0,3,0.0,1.0,0.0
A02948,5,12,0,17,0.29,0.71,0.0
A02949,0,1,0,1,0.0,1.0,0.0
A02950,0,3,0,3,0.0,1.0,0.0
A02951,8,8,0,16,0.5,0.5,0.0
A02953,0,4,0,4,0.0,1.0,0.0
A02954,0,10,0,10,0.0,1.0,0.0
A02955,2,8,0,10,0.2,0.8,0.0
A02957,1,5,0,6,0.17,0.83,0.0
A02959,2,5,0,7,0.29,0.71,0.0
A02960,1,4,0,5,0.2,0.8,0.0
A02961,5,4,0,9,0.56,0.44,0.0
A02962,0,1,0,1,0.0,1.0,0.0
A02964,1,5,0,6,0.17,0.83,0.0
A02966,0,1,0,1,0.0,1.0,0.0
A02967,0,5,0,5,0.0,1.0,0.0
A02968,1,1,0,2,0.5,0.5,0.0
A02970,1,3,0,4,0.25,0.75,0.0
A02971,0,3,0,3,0.0,1.0,0.0
A02972,0,1,0,1,0.0,1.0,0.0
A02973,0,7,0,7,0.0,1.0,0.0
A02974,2,2,0,4,0.5,0.5,0.0
A02975,0,1,0,1,0.0,1.0,0.0
A02976,3,2,0,5,0.6,0.4,0.0
A02977,1,0,0,1,1.0,0.0,0.0
A02978,0,1,0,1,0.0,1.0,0.0
A02979,3,3,0,6,0.5,0.5,0.0
A02980,3,0,0,3,1.0,0.0,0.0
A02982,7,20,0,27,0.26,0.74,0.0
A02983,2,6,0,8,0.25,0.75,0.0
A02984,0,4,0,4,0.0,1.0,0.0
A02985,2,4,0,6,0.33,0.67,0.0
A02986,2,0,0,2,1.0,0.0,0.0
A02987,3,3,0,6,0.5,0.5,0.0
A02989,1,2,0,3,0.33,0.67,0.0
A02990,1,2,0,3,0.33,0.67,0.0
A02991,4,5,0,9,0.44,0.56,0.0
A02992,7,6,0,13,0.54,0.46,0.0
A02993,0,5,0,5,0.0,1.0,0.0
A02994,1,2,0,3,0.33,0.67,0.0
A02995,0,1,0,1,0.0,1.0,0.0
A02998,0,1,0,1,0.0,1.0,0.0
A03000,3,4,0,7,0.43,0.57,0.0
A03001,0,1,0,1,0.0,1.0,0.0
A03002,0,7,0,7,0.0,1.0,0.0
A03003,0,2,0,2,0.0,1.0,0.0
A03004,0,8,0,8,0.0,1.0,0.0
A03005,1,9,0,10,0.1,0.9,0.0
A03008,0,2,0,2,0.0,1.0,0.0
A03009,2,2,0,4,0.5,0.5,0.0
A03010,0,1,0,1,0.0,1.0,0.0
A03015,8,17,0,25,0.32,0.68,0.0
A03017,0,2,0,2,0.0,1.0,0.0
A03018,0,3,0,3,0.0,1.0,0.0
A03020,2,0,0,2,1.0,0.0,0.0
A03022,1,3,0,4,0.25,0.75,0.0
A03023,0,1,0,1,0.0,1.0,0.0
A03024,3,3,0,6,0.5,0.5,0.0
A03025,1,2,0,3,0.33,0.67,0.0
A03026,0,2,0,2,0.0,1.0,0.0
A03027,1,4,0,5,0.2,0.8,0.0
A03028,4,7,0,11,0.36,0.64,0.0
A03029,0,10,0,10,0.0,1.0,0.0
A03031,0,2,0,2,0.0,1.0,0.0
A03032,0,2,0,2,0.0,1.0,0.0
A03033,0,5,0,5,0.0,1.0,0.0
A03034,0,2,0,2,0.0,1.0,0.0
A03036,1,2,0,3,0.33,0.67,0.0
A03038,0,3,0,3,0.0,1.0,0.0
A03039,1,4,0,5,0.2,0.8,0.0
A03041,0,3,0,3,0.0,1.0,0.0
A03042,0,3,0,3,0.0,1.0,0.0
A03044,1,3,0,4,0.25,0.75,0.0
A03045,0,5,0,5,0.0,1.0,0.0
A03046,1,4,0,5,0.2,0.8,0.0
A03047,1,7,0,8,0.12,0.88,0.0
A03048,3,16,0,19,0.16,0.84,0.0
A03050,3,4,0,7,0.43,0.57,0.0
A03051,0,2,0,2,0.0,1.0,0.0
A03055,1,3,0,4,0.25,0.75,0.0
A03057,0,5,0,5,0.0,1.0,0.0
A03059,0,2,0,2,0.0,1.0,0.0
A03060,3,7,0,10,0.3,0.7,0.0
A03061,0,4,0,4,0.0,1.0,0.0
A03062,0,2,0,2,0.0,1.0,0.0
A03063,0,2,0,2,0.0,1.0,0.0
A03064,0,1,0,1,0.0,1.0,0.0
A03065,0,2,0,2,0.0,1.0,0.0
A03066,4,9,0,13,0.31,0.69,0.0
A03067,1,2,0,3,0.33,0.67,0.0
A03071,3,13,0,16,0.19,0.81,0.0
A03073,0,1,0,1,0.0,1.0,0.0
A03074,1,5,0,6,0.17,0.83,0.0
A03075,1,0,0,1,1.0,0.0,0.0
A03076,1,5,0,6,0.17,0.83,0.0
A03077,0,5,0,5,0.0,1.0,0.0
A03080,0,9,0,9,0.0,1.0,0.0
A03081,0,1,0,1,0.0,1.0,0.0
A03082,3,5,0,8,0.38,0.62,0.0
A03083,2,5,0,7,0.29,0.71,0.0
A03084,0,1,0,1,0.0,1.0,0.0
A03085,12,15,0,27,0.44,0.56,0.0
A03086,2,6,0,8,0.25,0.75,0.0
A03087,3,2,0,5,0.6,0.4,0.0
A03088,7,7,0,14,0.5,0.5,0.0
A03091,1,1,0,2,0.5,0.5,0.0
A03092,0,6,0,6,0.0,1.0,0.0
A03094,0,6,0,6,0.0,1.0,0.0
A03095,0,1,0,1,0.0,1.0,0.0
A03096,0,2,0,2,0.0,1.0,0.0
A03097,14,9,0,23,0.61,0.39,0.0
A03098,1,12,0,13,0.08,0.92,0.0
A03099,0,4,0,4,0.0,1.0,0.0
A03100,0,3,0,3,0.0,1.0,0.0
A03103,2,10,0,12,0.17,0.83,0.0
A03104,0,1,0,1,0.0,1.0,0.0
A03105,0,2,0,2,0.0,1.0,0.0
A03106,0,9,0,9,0.0,1.0,0.0
A03107,0,1,0,1,0.0,1.0,0.0
A03108,2,1,0,3,0.67,0.33,0.0
A03109,0,2,0,2,0.0,1.0,0.0
A03110,1,5,0,6,0.17,0.83,0.0
A03112,0,2,0,2,0.0,1.0,0.0
A03113,0,3,0,3,0.0,1.0,0.0
A03114,0,7,0,7,0.0,1.0,0.0
A03115,3,3,0,6,0.5,0.5,0.0
A03116,0,1,0,1,0.0,1.0,0.0
A03117,0,2,0,2,0.0,1.0,0.0
A03118,0,3,0,3,0.0,1.0,0.0
A03119,1,4,0,5,0.2,0.8,0.0
A03120,0,5,0,5,0.0,1.0,0.0
A03122,0,3,0,3,0.0,1.0,0.0
A03123,4,7,0,11,0.36,0.64,0.0
A03124,2,9,0,11,0.18,0.82,0.0
A03126,0,10,0,10,0.0,1.0,0.0
A03127,1,2,0,3,0.33,0.67,0.0
A03129,0,2,0,2,0.0,1.0,0.0
A03130,0,1,0,1,0.0,1.0,0.0
A03131,18,7,0,25,0.72,0.28,0.0
A03135,0,1,0,1,0.0,1.0,0.0
A03137,0,1,0,1,0.0,1.0,0.0
A03138,2,1,0,3,0.67,0.33,0.0
A03139,1,4,0,5,0.2,0.8,0.0
A03140,2,1,0,3,0.67,0.33,0.0
A03141,0,2,0,2,0.0,1.0,0.0
A03142,0,1,0,1,0.0,1.0,0.0
A03147,1,5,0,6,0.17,0.83,0.0
A03150,2,6,0,8,0.25,0.75,0.0
A03151,0,5,0,5,0.0,1.0,0.0
A03152,0,1,0,1,0.0,1.0,0.0
A03153,11,11,0,22,0.5,0.5,0.0
A03154,3,10,0,13,0.23,0.77,0.0
A03155,2,8,0,10,0.2,0.8,0.0
A03156,1,1,0,2,0.5,0.5,0.0
A03157,1,2,0,3,0.33,0.67,0.0
A03158,0,2,0,2,0.0,1.0,0.0
A03159,1,8,0,9,0.11,0.89,0.0
A03160,1,3,0,4,0.25,0.75,0.0
A03161,2,4,0,6,0.33,0.67,0.0
A03162,1,1,0,2,0.5,0.5,0.0
A03163,0,1,0,1,0.0,1.0,0.0
A03164,1,3,0,4,0.25,0.75,0.0
A03165,4,5,0,9,0.44,0.56,0.0
A03167,2,1,0,3,0.67,0.33,0.0
A03168,0,1,0,1,0.0,1.0,0.0
A03169,3,3,0,6,0.5,0.5,0.0
A03170,1,2,0,3,0.33,0.67,0.0
A03171,0,1,0,1,0.0,1.0,0.0
A03172,1,7,0,8,0.12,0.88,0.0
A03173,0,1,0,1,0.0,1.0,0.0
A03174,1,11,0,12,0.08,0.92,0.0
A03175,2,4,0,6,0.33,0.67,0.0
A03176,6,6,0,12,0.5,0.5,0.0
A03178,3,2,0,5,0.6,0.4,0.0
A03180,5,2,0,7,0.71,0.29,0.0
A03181,0,3,0,3,0.0,1.0,0.0
A03183,1,5,0,6,0.17,0.83,0.0
A03184,1,6,0,7,0.14,0.86,0.0
A03186,0,1,0,1,0.0,1.0,0.0
A03187,1,0,0,1,1.0,0.0,0.0
A03188,4,6,0,10,0.4,0.6,0.0
A03189,5,4,0,9,0.56,0.44,0.0
A03190,0,6,0,6,0.0,1.0,0.0
A03191,1,3,1,5,0.2,0.6,0.2
A03192,4,11,0,15,0.27,0.73,0.0
A03193,0,2,0,2,0.0,1.0,0.0
A03194,0,2,0,2,0.0,1.0,0.0
A03195,2,1,0,3,0.67,0.33,0.0
A03198,0,2,0,2,0.0,1.0,0.0
A03199,2,5,0,7,0.29,0.71,0.0
A03200,1,4,0,5,0.2,0.8,0.0
A03201,0,1,0,1,0.0,1.0,0.0
A03204,1,1,0,2,0.5,0.5,0.0
A03205,0,2,0,2,0.0,1.0,0.0
A03206,5,4,0,9,0.56,0.44,0.0
A03209,3,10,0,13,0.23,0.77,0.0
A03210,1,5,0,6,0.17,0.83,0.0
A03211,0,1,0,1,0.0,1.0,0.0
A03213,2,2,0,4,0.5,0.5,0.0
A03215,0,1,0,1,0.0,1.0,0.0
A03216,3,5,0,8,0.38,0.62,0.0
A03217,1,4,0,5,0.2,0.8,0.0
A03218,2,4,0,6,0.33,0.67,0.0
A03219,0,5,0,5,0.0,1.0,0.0
A03220,1,3,0,4,0.25,0.75,0.0
A03222,1,2,0,3,0.33,0.67,0.0
A03223,0,8,0,8,0.0,1.0,0.0
A03224,1,7,0,8,0.12,0.88,0.0
A03226,3,9,0,12,0.25,0.75,0.0
A03227,0,1,0,1,0.0,1.0,0.0
A03228,3,3,0,6,0.5,0.5,0.0
A03229,0,2,0,2,0.0,1.0,0.0
A03230,0,2,0,2,0.0,1.0,0.0
A03231,0,8,0,8,0.0,1.0,0.0
A03232,1,1,0,2,0.5,0.5,0.0
A03233,0,2,0,2,0.0,1.0,0.0
A03234,2,26,0,28,0.07,0.93,0.0
A03235,1,1,0,2,0.5,0.5,0.0
A03236,0,2,0,2,0.0,1.0,0.0
A03237,0,2,0,2,0.0,1.0,0.0
A03238,0,1,0,1,0.0,1.0,0.0
A03239,1,3,0,4,0.25,0.75,0.0
A03240,3,9,0,12,0.25,0.75,0.0
A03241,0,8,0,8,0.0,1.0,0.0
A03242,0,7,0,7,0.0,1.0,0.0
A03243,2,4,0,6,0.33,0.67,0.0
A03244,7,13,0,20,0.35,0.65,0.0
A03245,0,1,0,1,0.0,1.0,0.0
A03246,0,2,0,2,0.0,1.0,0.0
A03247,16,1,0,17,0.94,0.06,0.0
A03248,1,3,0,4,0.25,0.75,0.0
A03249,0,2,0,2,0.0,1.0,0.0
A03250,2,5,0,7,0.29,0.71,0.0
A03251,30,13,0,43,0.7,0.3,0.0
A03252,0,1,0,1,0.0,1.0,0.0
A03253,6,9,0,15,0.4,0.6,0.0
A03254,6,10,0,16,0.38,0.62,0.0
A03255,6,2,0,8,0.75,0.25,0.0
A03256,3,3,0,6,0.5,0.5,0.0
A03257,1,6,0,7,0.14,0.86,0.0
A03259,2,3,0,5,0.4,0.6,0.0
A03260,5,10,0,15,0.33,0.67,0.0
A03263,5,9,0,14,0.36,0.64,0.0
A03264,1,6,0,7,0.14,0.86,0.0
A03265,0,2,1,3,0.0,0.67,0.33
A03266,0,5,0,5,0.0,1.0,0.0
A03268,3,9,0,12,0.25,0.75,0.0
A03269,2,6,2,10,0.2,0.6,0.2
A03270,1,8,0,9,0.11,0.89,0.0
A03271,4,5,0,9,0.44,0.56,0.0
A03272,1,0,0,1,1.0,0.0,0.0
A03273,5,9,0,14,0.36,0.64,0.0
A03274,64,8,0,72,0.89,0.11,0.0
A03275,1,0,0,1,1.0,0.0,0.0
A03276,2,4,0,6,0.33,0.67,0.0
A03279,2,7,0,9,0.22,0.78,0.0
A03281,1,82,0,83,0.01,0.99,0.0
A03282,0,1,0,1,0.0,1.0,0.0
A03283,0,3,0,3,0.0,1.0,0.0
A03284,5,12,0,17,0.29,0.71,0.0
A03285,0,1,0,1,0.0,1.0,0.0
A03287,0,11,0,11,0.0,1.0,0.0
A03288,0,4,0,4,0.0,1.0,0.0
A03289,1,0,0,1,1.0,0.0,0.0
A03290,3,5,0,8,0.38,0.62,0.0
A03291,51,9,0,60,0.85,0.15,0.0
A03292,0,1,0,1,0.0,1.0,0.0
A03293,8,19,0,27,0.3,0.7,0.0
A03294,0,7,0,7,0.0,1.0,0.0
A03295,0,1,0,1,0.0,1.0,0.0
A03296,16,3,5,24,0.67,0.12,0.21
A03297,1,8,0,9,0.11,0.89,0.0
A03298,0,1,0,1,0.0,1.0,0.0
A03299,2,6,0,8,0.25,0.75,0.0
A03300,0,1,0,1,0.0,1.0,0.0
A03303,2,4,0,6,0.33,0.67,0.0
A03309,1,2,0,3,0.33,0.67,0.0
A03312,0,5,0,5,0.0,1.0,0.0
A03313,0,1,0,1,0.0,1.0,0.0
A03314,0,2,0,2,0.0,1.0,0.0
A03315,1,3,0,4,0.25,0.75,0.0
A03316,0,1,0,1,0.0,1.0,0.0
A03317,9,28,0,37,0.24,0.76,0.0
A03319,0,1,0,1,0.0,1.0,0.0
A03320,3,13,0,16,0.19,0.81,0.0
A03322,6,8,0,14,0.43,0.57,0.0
A03323,3,6,0,9,0.33,0.67,0.0
A03324,3,4,0,7,0.43,0.57,0.0
A03325,0,4,0,4,0.0,1.0,0.0
A03326,4,6,0,10,0.4,0.6,0.0
A03327,0,1,0,1,0.0,1.0,0.0
A03328,0,4,0,4,0.0,1.0,0.0
A03330,4,7,0,11,0.36,0.64,0.0
A03331,2,3,0,5,0.4,0.6,0.0
A03332,3,2,0,5,0.6,0.4,0.0
A03333,1,18,0,19,0.05,0.95,0.0
A03335,0,8,0,8,0.0,1.0,0.0
A03337,7,12,0,19,0.37,0.63,0.0
A03338,1,4,0,5,0.2,0.8,0.0
A03339,1,3,0,4,0.25,0.75,0.0
A03340,6,24,0,30,0.2,0.8,0.0
A03342,0,2,0,2,0.0,1.0,0.0
A03343,1,10,0,11,0.09,0.91,0.0
A03345,1,5,0,6,0.17,0.83,0.0
A03346,8,6,0,14,0.57,0.43,0.0
A03347,1,1,0,2,0.5,0.5,0.0
A03348,0,5,0,5,0.0,1.0,0.0
A03349,1,5,0,6,0.17,0.83,0.0
A03351,2,10,0,12,0.17,0.83,0.0
A03352,0,4,0,4,0.0,1.0,0.0
A03353,0,4,0,4,0.0,1.0,0.0
A03354,0,3,0,3,0.0,1.0,0.0
A03355,0,1,0,1,0.0,1.0,0.0
A03356,1,1,0,2,0.5,0.5,0.0
A03357,1,4,0,5,0.2,0.8,0.0
A03358,3,22,0,25,0.12,0.88,0.0
A03359,0,1,0,1,0.0,1.0,0.0
A03360,0,1,0,1,0.0,1.0,0.0
A03361,0,2,0,2,0.0,1.0,0.0
A03363,8,47,0,55,0.15,0.85,0.0
A03364,6,11,0,17,0.35,0.65,0.0
A03365,4,6,1,11,0.36,0.55,0.09
A03366,2,12,0,14,0.14,0.86,0.0
A03367,1,4,0,5,0.2,0.8,0.0
A03369,1,4,0,5,0.2,0.8,0.0
A03371,0,1,0,1,0.0,1.0,0.0
A03373,5,15,0,20,0.25,0.75,0.0
A03374,2,6,0,8,0.25,0.75,0.0
A03375,0,5,0,5,0.0,1.0,0.0
A03376,0,9,0,9,0.0,1.0,0.0
A03377,0,5,0,5,0.0,1.0,0.0
A03378,0,1,0,1,0.0,1.0,0.0
A03379,0,6,0,6,0.0,1.0,0.0
A03380,2,6,0,8,0.25,0.75,0.0
A03381,1,4,0,5,0.2,0.8,0.0
A03382,1,1,0,2,0.5,0.5,0.0
A03383,0,8,0,8,0.0,1.0,0.0
A03385,0,3,0,3,0.0,1.0,0.0
A03386,1,4,0,5,0.2,0.8,0.0
A03387,0,8,0,8,0.0,1.0,0.0
A03388,1,15,0,16,0.06,0.94,0.0
A03389,5,4,0,9,0.56,0.44,0.0
A03390,0,3,0,3,0.0,1.0,0.0
A03391,1,4,0,5,0.2,0.8,0.0
A03392,6,16,0,22,0.27,0.73,0.0
A03394,0,13,0,13,0.0,1.0,0.0
A03396,1,1,0,2,0.5,0.5,0.0
A03397,0,7,0,7,0.0,1.0,0.0
A03398,1,7,0,8,0.12,0.88,0.0
A03399,0,2,0,2,0.0,1.0,0.0
A03402,0,3,0,3,0.0,1.0,0.0
A03403,0,2,0,2,0.0,1.0,0.0
A03404,1,3,0,4,0.25,0.75,0.0
A03405,0,1,0,1,0.0,1.0,0.0
A03406,1,11,0,12,0.08,0.92,0.0
A03407,9,14,0,23,0.39,0.61,0.0
A03408,2,2,0,4,0.5,0.5,0.0
A03409,4,7,0,11,0.36,0.64,0.0
A03411,1,3,0,4,0.25,0.75,0.0
A03412,6,12,0,18,0.33,0.67,0.0
A03413,1,5,0,6,0.17,0.83,0.0
A03414,0,3,0,3,0.0,1.0,0.0
A03415,0,1,0,1,0.0,1.0,0.0
A03416,1,2,0,3,0.33,0.67,0.0
A03417,0,3,0,3,0.0,1.0,0.0
A03418,0,2,0,2,0.0,1.0,0.0
A03419,0,2,0,2,0.0,1.0,0.0
A03420,1,2,0,3,0.33,0.67,0.0
A03421,2,6,0,8,0.25,0.75,0.0
A03422,0,2,0,2,0.0,1.0,0.0
A03423,0,3,0,3,0.0,1.0,0.0
A03424,1,0,0,1,1.0,0.0,0.0
A03425,0,1,0,1,0.0,1.0,0.0
A03426,0,2,0,2,0.0,1.0,0.0
A03428,1,1,0,2,0.5,0.5,0.0
A03429,0,1,0,1,0.0,1.0,0.0
A03431,0,1,0,1,0.0,1.0,0.0
A03432,2,1,0,3,0.67,0.33,0.0
A03433,3,9,0,12,0.25,0.75,0.0
A03434,0,2,0,2,0.0,1.0,0.0
A03435,3,3,0,6,0.5,0.5,0.0
A03436,8,7,0,15,0.53,0.47,0.0
A03437,3,2,0,5,0.6,0.4,0.0
A03438,2,7,0,9,0.22,0.78,0.0
A03439,9,19,0,28,0.32,0.68,0.0
A03440,1,1,0,2,0.5,0.5,0.0
A03441,1,6,0,7,0.14,0.86,0.0
A03442,21,14,0,35,0.6,0.4,0.0
A03443,0,1,0,1,0.0,1.0,0.0
A03444,2,3,0,5,0.4,0.6,0.0
A03445,1,1,0,2,0.5,0.5,0.0
A03446,1,6,0,7,0.14,0.86,0.0
A03447,2,5,0,7,0.29,0.71,0.0
A03448,0,1,0,1,0.0,1.0,0.0
A03449,0,3,0,3,0.0,1.0,0.0
A03450,1,2,0,3,0.33,0.67,0.0
A03452,0,1,0,1,0.0,1.0,0.0
A03453,1,0,0,1,1.0,0.0,0.0
A03454,3,7,0,10,0.3,0.7,0.0
A03455,5,6,0,11,0.45,0.55,0.0
A03456,0,3,0,3,0.0,1.0,0.0
A03457,0,2,0,2,0.0,1.0,0.0
A03458,0,2,0,2,0.0,1.0,0.0
A03459,2,7,0,9,0.22,0.78,0.0
A03461,6,11,1,18,0.33,0.61,0.06
A03462,1,0,0,1,1.0,0.0,0.0
A03464,1,3,0,4,0.25,0.75,0.0
A03465,1,6,0,7,0.14,0.86,0.0
A03466,0,2,0,2,0.0,1.0,0.0
A03467,0,2,0,2,0.0,1.0,0.0
A03468,0,2,0,2,0.0,1.0,0.0
A03469,0,1,0,1,0.0,1.0,0.0
A03470,1,1,0,2,0.5,0.5,0.0
A03471,3,8,0,11,0.27,0.73,0.0
A03472,1,3,0,4,0.25,0.75,0.0
A03474,2,7,0,9,0.22,0.78,0.0
A03475,1,0,0,1,1.0,0.0,0.0
A03478,0,1,0,1,0.0,1.0,0.0
A03479,0,1,0,1,0.0,1.0,0.0
A03480,1,1,0,2,0.5,0.5,0.0
A03481,0,5,0,5,0.0,1.0,0.0
A03482,3,4,0,7,0.43,0.57,0.0
A03483,0,1,0,1,0.0,1.0,0.0
A03484,0,2,0,2,0.0,1.0,0.0
A03485,0,6,0,6,0.0,1.0,0.0
A03486,1,10,0,11,0.09,0.91,0.0
A03487,7,4,0,11,0.64,0.36,0.0
A03488,5,7,0,12,0.42,0.58,0.0
A03489,5,5,0,10,0.5,0.5,0.0
A03494,0,1,0,1,0.0,1.0,0.0
A03495,2,10,0,12,0.17,0.83,0.0
A03496,1,5,0,6,0.17,0.83,0.0
A03497,0,3,0,3,0.0,1.0,0.0
A03498,5,7,0,12,0.42,0.58,0.0
A03499,1,4,0,5,0.2,0.8,0.0
A03500,4,11,0,15,0.27,0.73,0.0
A03501,0,13,0,13,0.0,1.0,0.0
A03502,2,0,0,2,1.0,0.0,0.0
A03503,1,3,0,4,0.25,0.75,0.0
A03504,0,1,0,1,0.0,1.0,0.0
A03505,3,7,0,10,0.3,0.7,0.0
A03506,0,2,0,2,0.0,1.0,0.0
A03507,2,2,0,4,0.5,0.5,0.0
A03508,0,1,0,1,0.0,1.0,0.0
A03509,1,0,0,1,1.0,0.0,0.0
A03510,0,4,0,4,0.0,1.0,0.0
A03511,1,1,0,2,0.5,0.5,0.0
A03513,0,2,0,2,0.0,1.0,0.0
A03515,4,23,0,27,0.15,0.85,0.0
A03517,5,6,0,11,0.45,0.55,0.0
A03518,0,5,0,5,0.0,1.0,0.0
A03519,0,4,0,4,0.0,1.0,0.0
A03520,0,3,0,3,0.0,1.0,0.0
A03521,1,0,0,1,1.0,0.0,0.0
A03522,4,3,0,7,0.57,0.43,0.0
A03523,10,20,0,30,0.33,0.67,0.0
A03524,5,6,0,11,0.45,0.55,0.0
A03525,0,4,0,4,0.0,1.0,0.0
A03526,0,6,1,7,0.0,0.86,0.14
A03527,0,6,0,6,0.0,1.0,0.0
A03528,4,5,0,9,0.44,0.56,0.0
A03529,1,9,0,10,0.1,0.9,0.0
A03531,0,2,0,2,0.0,1.0,0.0
A03532,5,5,0,10,0.5,0.5,0.0
A03533,4,5,0,9,0.44,0.56,0.0
A03535,0,5,0,5,0.0,1.0,0.0
A03537,0,6,0,6,0.0,1.0,0.0
A03538,0,11,0,11,0.0,1.0,0.0
A03539,0,5,0,5,0.0,1.0,0.0
A03541,3,12,0,15,0.2,0.8,0.0
A03542,8,7,0,15,0.53,0.47,0.0
A03545,4,8,0,12,0.33,0.67,0.0
A03547,1,1,0,2,0.5,0.5,0.0
A03549,1,7,0,8,0.12,0.88,0.0
A03550,1,0,0,1,1.0,0.0,0.0
A03552,0,5,0,5,0.0,1.0,0.0
A03553,0,1,0,1,0.0,1.0,0.0
A03554,1,2,0,3,0.33,0.67,0.0
A03555,0,1,0,1,0.0,1.0,0.0
A03556,5,2,0,7,0.71,0.29,0.0
A03557,2,3,0,5,0.4,0.6,0.0
A03558,0,9,0,9,0.0,1.0,0.0
A03559,3,4,0,7,0.43,0.57,0.0
A03560,3,5,0,8,0.38,0.62,0.0
A03562,0,4,0,4,0.0,1.0,0.0
A03565,0,5,0,5,0.0,1.0,0.0
A03566,23,29,0,52,0.44,0.56,0.0
A03568,4,4,0,8,0.5,0.5,0.0
A03569,1,8,0,9,0.11,0.89,0.0
A03570,8,6,0,14,0.57,0.43,0.0
A03571,0,1,0,1,0.0,1.0,0.0
A03572,0,2,0,2,0.0,1.0,0.0
A03573,1,8,0,9,0.11,0.89,0.0
A03574,3,3,0,6,0.5,0.5,0.0
A03575,1,9,0,10,0.1,0.9,0.0
A03576,0,6,0,6,0.0,1.0,0.0
A03577,5,12,1,18,0.28,0.67,0.06
A03578,0,3,0,3,0.0,1.0,0.0
A03579,1,0,0,1,1.0,0.0,0.0
A03580,0,8,0,8,0.0,1.0,0.0
A03581,1,2,0,3,0.33,0.67,0.0
A03582,0,1,0,1,0.0,1.0,0.0
A03583,5,6,0,11,0.45,0.55,0.0
A03584,1,8,0,9,0.11,0.89,0.0
A03585,2,1,0,3,0.67,0.33,0.0
A03586,1,2,0,3,0.33,0.67,0.0
A03587,3,3,0,6,0.5,0.5,0.0
A03588,1,3,0,4,0.25,0.75,0.0
A03589,1,3,0,4,0.25,0.75,0.0
A03590,0,2,0,2,0.0,1.0,0.0
A03591,1,2,0,3,0.33,0.67,0.0
A03593,4,22,0,26,0.15,0.85,0.0
A03594,0,2,0,2,0.0,1.0,0.0
A03595,1,5,0,6,0.17,0.83,0.0
A03596,1,3,0,4,0.25,0.75,0.0
A03597,1,6,0,7,0.14,0.86,0.0
A03598,1,8,0,9,0.11,0.89,0.0
A03599,2,9,0,11,0.18,0.82,0.0
A03600,0,4,0,4,0.0,1.0,0.0
A03601,1,4,0,5,0.2,0.8,0.0
A03602,0,4,0,4,0.0,1.0,0.0
A03603,1,0,0,1,1.0,0.0,0.0
A03604,2,6,0,8,0.25,0.75,0.0
A03605,1,3,0,4,0.25,0.75,0.0
A03606,0,5,0,5,0.0,1.0,0.0
A03607,2,0,0,2,1.0,0.0,0.0
A03608,3,8,0,11,0.27,0.73,0.0
A03609,1,4,0,5,0.2,0.8,0.0
A03610,0,1,0,1,0.0,1.0,0.0
A03611,1,5,0,6,0.17,0.83,0.0
A03612,18,21,0,39,0.46,0.54,0.0
A03613,2,3,0,5,0.4,0.6,0.0
A03614,2,5,0,7,0.29,0.71,0.0
A03615,0,8,0,8,0.0,1.0,0.0
A03617,0,1,0,1,0.0,1.0,0.0
A03618,0,4,0,4,0.0,1.0,0.0
A03619,1,4,0,5,0.2,0.8,0.0
A03620,6,13,0,19,0.32,0.68,0.0
A03621,1,1,0,2,0.5,0.5,0.0
A03622,0,1,0,1,0.0,1.0,0.0
A03623,0,1,0,1,0.0,1.0,0.0
A03625,5,12,0,17,0.29,0.71,0.0
A03626,2,1,0,3,0.67,0.33,0.0
A03627,3,14,0,17,0.18,0.82,0.0
A03628,0,2,0,2,0.0,1.0,0.0
A03629,0,2,0,2,0.0,1.0,0.0
A03630,1,10,0,11,0.09,0.91,0.0
A03632,0,1,0,1,0.0,1.0,0.0
A03633,0,1,0,1,0.0,1.0,0.0
A03634,19,13,0,32,0.59,0.41,0.0
A03635,2,2,0,4,0.5,0.5,0.0
A03636,0,6,0,6,0.0,1.0,0.0
A03637,2,2,0,4,0.5,0.5,0.0
A03638,0,5,0,5,0.0,1.0,0.0
A03639,0,3,0,3,0.0,1.0,0.0
A03640,2,5,0,7,0.29,0.71,0.0
A03641,9,5,0,14,0.64,0.36,0.0
A03642,0,1,0,1,0.0,1.0,0.0
A03643,0,1,0,1,0.0,1.0,0.0
A03644,0,6,0,6,0.0,1.0,0.0
A03645,5,11,0,16,0.31,0.69,0.0
A03646,0,1,0,1,0.0,1.0,0.0
A03647,1,5,0,6,0.17,0.83,0.0
A03648,0,5,0,5,0.0,1.0,0.0
A03650,2,12,0,14,0.14,0.86,0.0
A03651,0,1,0,1,0.0,1.0,0.0
A03652,1,2,0,3,0.33,0.67,0.0
A03653,5,1,0,6,0.83,0.17,0.0
A03654,0,5,0,5,0.0,1.0,0.0
A03655,1,3,0,4,0.25,0.75,0.0
A03656,5,5,0,10,0.5,0.5,0.0
A03659,0,1,0,1,0.0,1.0,0.0
A03660,1,0,0,1,1.0,0.0,0.0
A03661,0,3,0,3,0.0,1.0,0.0
A03662,0,3,0,3,0.0,1.0,0.0
A03663,5,2,0,7,0.71,0.29,0.0
A03664,5,2,0,7,0.71,0.29,0.0
A03665,1,4,0,5,0.2,0.8,0.0
A03666,0,3,0,3,0.0,1.0,0.0
A03667,0,7,0,7,0.0,1.0,0.0
A03668,8,9,0,17,0.47,0.53,0.0
A03669,7,7,0,14,0.5,0.5,0.0
A03670,7,4,1,12,0.58,0.33,0.08
A03671,1,7,0,8,0.12,0.88,0.0
A03672,3,2,0,5,0.6,0.4,0.0
A03673,4,8,0,12,0.33,0.67,0.0
A03674,0,3,0,3,0.0,1.0,0.0
A03675,0,5,0,5,0.0,1.0,0.0
A03676,1,3,0,4,0.25,0.75,0.0
A03677,1,10,0,11,0.09,0.91,0.0
A03678,25,13,6,44,0.57,0.3,0.14
A03679,0,1,0,1,0.0,1.0,0.0
A03680,3,4,0,7,0.43,0.57,0.0
A03681,0,3,0,3,0.0,1.0,0.0
A03682,9,0,0,9,1.0,0.0,0.0
A03683,34,14,0,48,0.71,0.29,0.0
A03684,0,7,0,7,0.0,1.0,0.0
A03685,1,10,0,11,0.09,0.91,0.0
A03686,0,1,0,1,0.0,1.0,0.0
A03687,5,10,0,15,0.33,0.67,0.0
A03688,1,1,0,2,0.5,0.5,0.0
A03689,2,4,0,6,0.33,0.67,0.0
A03690,2,7,0,9,0.22,0.78,0.0
A03691,4,8,0,12,0.33,0.67,0.0
A03692,0,1,0,1,0.0,1.0,0.0
A03693,9,0,0,9,1.0,0.0,0.0
A03694,3,3,0,6,0.5,0.5,0.0
A03695,12,2,0,14,0.86,0.14,0.0
A03696,0,1,0,1,0.0,1.0,0.0
A03697,16,3,0,19,0.84,0.16,0.0
A03698,1,2,0,3,0.33,0.67,0.0
A03699,3,7,0,10,0.3,0.7,0.0
A03700,1,2,0,3,0.33,0.67,0.0
A03701,2,1,0,3,0.67,0.33,0.0
A03702,0,1,0,1,0.0,1.0,0.0
A03703,2,4,0,6,0.33,0.67,0.0
A03704,2,7,0,9,0.22,0.78,0.0
A03705,16,4,0,20,0.8,0.2,0.0
A03707,1,4,0,5,0.2,0.8,0.0
A03708,0,3,0,3,0.0,1.0,0.0
A03709,5,12,0,17,0.29,0.71,0.0
A03710,0,5,0,5,0.0,1.0,0.0
A03712,3,5,0,8,0.38,0.62,0.0
A03713,0,2,0,2,0.0,1.0,0.0
A03714,1,1,0,2,0.5,0.5,0.0
A03715,22,9,0,31,0.71,0.29,0.0
A03716,0,2,0,2,0.0,1.0,0.0
A03717,3,12,0,15,0.2,0.8,0.0
A03718,0,1,0,1,0.0,1.0,0.0
A03719,1,1,0,2,0.5,0.5,0.0
A03720,1,4,0,5,0.2,0.8,0.0
A03721,0,1,0,1,0.0,1.0,0.0
A03722,1,4,0,5,0.2,0.8,0.0
A03723,9,10,0,19,0.47,0.53,0.0
A03726,2,7,0,9,0.22,0.78,0.0
A03727,0,1,0,1,0.0,1.0,0.0
A03728,24,4,0,28,0.86,0.14,0.0
A03729,3,6,0,9,0.33,0.67,0.0
A03730,0,1,0,1,0.0,1.0,0.0
A03732,45,4,0,49,0.92,0.08,0.0
A03734,3,7,0,10,0.3,0.7,0.0
A03735,4,3,0,7,0.57,0.43,0.0
A03736,2,2,0,4,0.5,0.5,0.0
A03737,1,2,0,3,0.33,0.67,0.0
A03738,8,8,0,16,0.5,0.5,0.0
A03739,0,3,0,3,0.0,1.0,0.0
A03740,0,5,0,5,0.0,1.0,0.0
A03741,32,23,2,57,0.56,0.4,0.04
A03742,0,6,0,6,0.0,1.0,0.0
A03743,47,14,0,61,0.77,0.23,0.0
A03744,0,5,0,5,0.0,1.0,0.0
A03746,1,2,0,3,0.33,0.67,0.0
A03747,3,8,0,11,0.27,0.73,0.0
A03748,3,15,0,18,0.17,0.83,0.0
A03749,3,3,0,6,0.5,0.5,0.0
A03750,2,7,0,9,0.22,0.78,0.0
A03751,1,1,0,2,0.5,0.5,0.0
A03752,6,6,0,12,0.5,0.5,0.0
A03753,9,7,0,16,0.56,0.44,0.0
A03754,0,1,0,1,0.0,1.0,0.0
A03755,3,8,0,11,0.27,0.73,0.0
A03756,4,8,0,12,0.33,0.67,0.0
A03757,0,5,0,5,0.0,1.0,0.0
A03758,4,3,0,7,0.57,0.43,0.0
A03759,0,3,0,3,0.0,1.0,0.0
A03760,1,2,0,3,0.33,0.67,0.0
A03761,1,3,0,4,0.25,0.75,0.0
A03762,1,2,0,3,0.33,0.67,0.0
A03763,2,1,0,3,0.67,0.33,0.0
A03764,2,3,0,5,0.4,0.6,0.0
A03765,0,1,0,1,0.0,1.0,0.0
A03766,40,24,0,64,0.62,0.38,0.0
A03767,4,2,0,6,0.67,0.33,0.0
A03768,1,7,0,8,0.12,0.88,0.0
A03769,0,1,0,1,0.0,1.0,0.0
A03770,2,5,0,7,0.29,0.71,0.0
A03771,1,0,0,1,1.0,0.0,0.0
A03772,2,9,0,11,0.18,0.82,0.0
A03773,0,3,0,3,0.0,1.0,0.0
A03774,13,6,0,19,0.68,0.32,0.0
A03775,0,3,0,3,0.0,1.0,0.0
A03776,3,8,0,11,0.27,0.73,0.0
A03777,3,3,0,6,0.5,0.5,0.0
A03778,3,6,0,9,0.33,0.67,0.0
A03779,1,13,0,14,0.07,0.93,0.0
A03780,5,20,0,25,0.2,0.8,0.0
A03781,6,11,0,17,0.35,0.65,0.0
A03782,12,12,0,24,0.5,0.5,0.0
A03783,3,14,0,17,0.18,0.82,0.0
A03784,3,1,0,4,0.75,0.25,0.0
A03785,1,0,0,1,1.0,0.0,0.0
A03786,2,4,0,6,0.33,0.67,0.0
A03787,6,12,1,19,0.32,0.63,0.05
A03789,10,6,0,16,0.62,0.38,0.0
A03790,6,2,0,8,0.75,0.25,0.0
A03791,0,1,0,1,0.0,1.0,0.0
A03792,8,5,0,13,0.62,0.38,0.0
A03793,1,1,0,2,0.5,0.5,0.0
A03794,1,1,0,2,0.5,0.5,0.0
A03795,1,1,0,2,0.5,0.5,0.0
A03796,1,4,0,5,0.2,0.8,0.0
A03797,0,3,0,3,0.0,1.0,0.0
A03798,0,6,0,6,0.0,1.0,0.0
A03799,0,1,0,1,0.0,1.0,0.0
A03800,0,2,0,2,0.0,1.0,0.0
A03801,0,3,0,3,0.0,1.0,0.0
A03802,1,2,0,3,0.33,0.67,0.0
A03803,2,2,0,4,0.5,0.5,0.0
A03804,0,14,0,14,0.0,1.0,0.0
A03805,4,8,0,12,0.33,0.67,0.0
A03806,2,8,0,10,0.2,0.8,0.0
A03807,3,3,0,6,0.5,0.5,0.0
A03808,8,6,0,14,0.57,0.43,0.0
A03809,4,10,0,14,0.29,0.71,0.0
A03810,2,10,0,12,0.17,0.83,0.0
A03811,1,3,0,4,0.25,0.75,0.0
A03812,2,5,0,7,0.29,0.71,0.0
A03813,0,11,0,11,0.0,1.0,0.0
A03814,0,1,0,1,0.0,1.0,0.0
A03815,2,6,1,9,0.22,0.67,0.11
A03816,1,4,0,5,0.2,0.8,0.0
A03817,5,22,0,27,0.19,0.81,0.0
A03819,1,3,0,4,0.25,0.75,0.0
A03820,3,13,0,16,0.19,0.81,0.0
A03822,3,1,0,4,0.75,0.25,0.0
A03823,4,7,0,11,0.36,0.64,0.0
A03824,0,2,0,2,0.0,1.0,0.0
A03825,4,3,0,7,0.57,0.43,0.0
A03826,2,5,0,7,0.29,0.71,0.0
A03828,0,1,0,1,0.0,1.0,0.0
A03829,2,2,0,4,0.5,0.5,0.0
A03830,1,10,0,11,0.09,0.91,0.0
A03831,1,7,0,8,0.12,0.88,0.0
A03832,6,13,0,19,0.32,0.68,0.0
A03833,10,5,0,15,0.67,0.33,0.0
A03835,0,1,0,1,0.0,1.0,0.0
A03836,1,2,0,3,0.33,0.67,0.0
A03838,6,10,0,16,0.38,0.62,0.0
A03839,3,9,0,12,0.25,0.75,0.0
A03840,0,1,0,1,0.0,1.0,0.0
A03841,5,2,0,7,0.71,0.29,0.0
A03842,6,10,0,16,0.38,0.62,0.0
A03843,0,4,0,4,0.0,1.0,0.0
A03844,0,5,0,5,0.0,1.0,0.0
A03845,0,1,0,1,0.0,1.0,0.0
A03846,1,2,0,3,0.33,0.67,0.0
A03847,3,1,0,4,0.75,0.25,0.0
A03848,0,10,0,10,0.0,1.0,0.0
A03849,5,8,0,13,0.38,0.62,0.0
A03850,8,6,0,14,0.57,0.43,0.0
A03851,2,1,0,3,0.67,0.33,0.0
A03852,1,7,0,8,0.12,0.88,0.0
A03855,1,1,0,2,0.5,0.5,0.0
A03856,5,2,0,7,0.71,0.29,0.0
A03857,0,1,0,1,0.0,1.0,0.0
A03858,2,7,0,9,0.22,0.78,0.0
A03859,0,1,0,1,0.0,1.0,0.0
A03860,2,7,0,9,0.22,0.78,0.0
A03861,1,2,0,3,0.33,0.67,0.0
A03862,0,3,1,4,0.0,0.75,0.25
A03863,2,2,0,4,0.5,0.5,0.0
A03864,0,6,0,6,0.0,1.0,0.0
A03866,0,2,0,2,0.0,1.0,0.0
A03867,6,5,0,11,0.55,0.45,0.0
A03868,2,11,0,13,0.15,0.85,0.0
A03869,5,25,0,30,0.17,0.83,0.0
A03870,3,6,0,9,0.33,0.67,0.0
A03872,1,5,0,6,0.17,0.83,0.0
A03873,1,0,0,1,1.0,0.0,0.0
A03875,0,2,0,2,0.0,1.0,0.0
A03876,2,2,0,4,0.5,0.5,0.0
A03877,3,4,0,7,0.43,0.57,0.0
A03878,0,1,0,1,0.0,1.0,0.0
A03879,1,8,0,9,0.11,0.89,0.0
A03881,7,13,0,20,0.35,0.65,0.0
A03882,0,5,0,5,0.0,1.0,0.0
A03883,3,4,0,7,0.43,0.57,0.0
A03884,4,6,0,10,0.4,0.6,0.0
A03885,1,5,0,6,0.17,0.83,0.0
A03886,1,2,0,3,0.33,0.67,0.0
A03887,1,3,0,4,0.25,0.75,0.0
A03888,4,5,0,9,0.44,0.56,0.0
A03891,7,8,0,15,0.47,0.53,0.0
A03892,1,1,0,2,0.5,0.5,0.0
A03894,2,24,0,26,0.08,0.92,0.0
A03895,0,3,0,3,0.0,1.0,0.0
A03896,4,6,0,10,0.4,0.6,0.0
A03897,0,5,0,5,0.0,1.0,0.0
A03898,0,1,0,1,0.0,1.0,0.0
A03899,1,2,0,3,0.33,0.67,0.0
A03900,0,4,0,4,0.0,1.0,0.0
A03901,0,1,0,1,0.0,1.0,0.0
A03902,5,0,0,5,1.0,0.0,0.0
A03903,0,3,0,3,0.0,1.0,0.0
A03904,0,3,0,3,0.0,1.0,0.0
A03906,9,10,0,19,0.47,0.53,0.0
A03907,0,2,0,2,0.0,1.0,0.0
A03908,3,2,0,5,0.6,0.4,0.0
A03910,1,5,0,6,0.17,0.83,0.0
A03911,2,7,0,9,0.22,0.78,0.0
A03912,1,4,0,5,0.2,0.8,0.0
A03913,1,2,0,3,0.33,0.67,0.0
A03915,0,2,0,2,0.0,1.0,0.0
A03916,9,19,0,28,0.32,0.68,0.0
A03917,1,3,0,4,0.25,0.75,0.0
A03919,2,0,0,2,1.0,0.0,0.0
A03920,4,3,0,7,0.57,0.43,0.0
A03921,3,13,0,16,0.19,0.81,0.0
A03922,8,8,2,18,0.44,0.44,0.11
A03923,2,7,0,9,0.22,0.78,0.0
A03924,3,0,0,3,1.0,0.0,0.0
A03925,3,2,0,5,0.6,0.4,0.0
A03926,3,4,0,7,0.43,0.57,0.0
A03927,2,2,0,4,0.5,0.5,0.0
A03928,1,2,0,3,0.33,0.67,0.0
A03929,1,1,0,2,0.5,0.5,0.0
A03930,5,2,0,7,0.71,0.29,0.0
A03931,3,2,0,5,0.6,0.4,0.0
A03932,4,1,0,5,0.8,0.2,0.0
A03933,5,3,0,8,0.62,0.38,0.0
A03934,1,1,0,2,0.5,0.5,0.0
A03936,14,14,0,28,0.5,0.5,0.0
A03937,2,6,0,8,0.25,0.75,0.0
A03938,9,14,0,23,0.39,0.61,0.0
A03939,0,1,0,1,0.0,1.0,0.0
A03940,1,1,0,2,0.5,0.5,0.0
A03941,2,6,0,8,0.25,0.75,0.0
A03942,2,3,0,5,0.4,0.6,0.0
A03943,1,0,0,1,1.0,0.0,0.0
A03944,1,1,0,2,0.5,0.5,0.0
A03945,0,3,0,3,0.0,1.0,0.0
A03946,1,3,0,4,0.25,0.75,0.0
A03947,2,10,0,12,0.17,0.83,0.0
A03949,1,2,0,3,0.33,0.67,0.0
A03950,0,1,0,1,0.0,1.0,0.0
A03951,5,3,0,8,0.62,0.38,0.0
A03952,2,3,0,5,0.4,0.6,0.0
A03953,3,5,0,8,0.38,0.62,0.0
A03954,0,2,0,2,0.0,1.0,0.0
A03957,1,2,0,3,0.33,0.67,0.0
A03960,6,5,0,11,0.55,0.45,0.0
A03964,0,1,0,1,0.0,1.0,0.0
A03965,1,1,0,2,0.5,0.5,0.0
A03966,2,6,0,8,0.25,0.75,0.0
A03968,1,0,0,1,1.0,0.0,0.0
A03969,6,6,0,12,0.5,0.5,0.0
A03970,4,10,0,14,0.29,0.71,0.0
A03972,2,3,0,5,0.4,0.6,0.0
A03974,3,9,1,13,0.23,0.69,0.08
A03975,4,0,0,4,1.0,0.0,0.0
A03977,1,1,0,2,0.5,0.5,0.0
A03978,4,2,0,6,0.67,0.33,0.0
A03979,7,8,0,15,0.47,0.53,0.0
A03980,5,0,0,5,1.0,0.0,0.0
A03981,1,3,0,4,0.25,0.75,0.0
A03982,1,4,0,5,0.2,0.8,0.0
A03983,0,1,0,1,0.0,1.0,0.0
A03984,3,1,0,4,0.75,0.25,0.0
A03985,0,1,0,1,0.0,1.0,0.0
A03987,1,2,0,3,0.33,0.67,0.0
A03988,0,1,0,1,0.0,1.0,0.0
A03989,3,3,0,6,0.5,0.5,0.0
A03990,1,4,0,5,0.2,0.8,0.0
A03991,1,4,0,5,0.2,0.8,0.0
A03992,0,3,0,3,0.0,1.0,0.0
A03993,8,5,0,13,0.62,0.38,0.0
A03995,0,6,0,6,0.0,1.0,0.0
A03996,6,1,6,13,0.46,0.08,0.46
A03997,4,4,0,8,0.5,0.5,0.0
A03998,1,1,0,2,0.5,0.5,0.0
A03999,1,1,0,2,0.5,0.5,0.0
A04000,0,2,0,2,0.0,1.0,0.0
A04001,2,7,0,9,0.22,0.78,0.0
A04002,0,5,0,5,0.0,1.0,0.0
A04003,1,2,0,3,0.33,0.67,0.0
A04004,1,2,0,3,0.33,0.67,0.0
A04006,1,5,0,6,0.17,0.83,0.0
A04007,1,4,0,5,0.2,0.8,0.0
A04008,1,0,0,1,1.0,0.0,0.0
A04009,2,0,0,2,1.0,0.0,0.0
A04010,2,7,0,9,0.22,0.78,0.0
A04011,0,1,0,1,0.0,1.0,0.0
A04012,4,1,1,6,0.67,0.17,0.17
A04013,3,9,0,12,0.25,0.75,0.0
A04014,2,2,0,4,0.5,0.5,0.0
A04015,0,2,0,2,0.0,1.0,0.0
A04016,5,5,0,10,0.5,0.5,0.0
A04017,3,3,0,6,0.5,0.5,0.0
A04018,1,1,0,2,0.5,0.5,0.0
A04019,2,2,0,4,0.5,0.5,0.0
A04020,1,4,0,5,0.2,0.8,0.0
A04021,3,4,0,7,0.43,0.57,0.0
A04022,1,1,0,2,0.5,0.5,0.0
A04023,3,2,0,5,0.6,0.4,0.0
A04024,13,14,0,27,0.48,0.52,0.0
A04025,3,5,0,8,0.38,0.62,0.0
A04026,4,1,0,5,0.8,0.2,0.0
A04027,2,0,0,2,1.0,0.0,0.0
A04029,5,5,0,10,0.5,0.5,0.0
A04030,9,5,4,18,0.5,0.28,0.22
A04032,1,0,0,1,1.0,0.0,0.0
A04033,4,2,0,6,0.67,0.33,0.0
A04035,1,1,0,2,0.5,0.5,0.0
A04036,24,11,0,35,0.69,0.31,0.0
A04037,0,3,0,3,0.0,1.0,0.0
A04038,2,2,0,4,0.5,0.5,0.0
A04039,1,2,0,3,0.33,0.67,0.0
A04040,4,8,0,12,0.33,0.67,0.0
A04041,2,1,0,3,0.67,0.33,0.0
A04042,1,2,0,3,0.33,0.67,0.0
A04043,0,8,0,8,0.0,1.0,0.0
A04044,0,6,0,6,0.0,1.0,0.0
A04045,4,7,0,11,0.36,0.64,0.0
A04046,6,7,0,13,0.46,0.54,0.0
A04047,2,6,0,8,0.25,0.75,0.0
A04048,0,1,0,1,0.0,1.0,0.0
A04049,0,2,0,2,0.0,1.0,0.0
A04050,0,2,0,2,0.0,1.0,0.0
A04051,0,2,0,2,0.0,1.0,0.0
A04052,0,5,0,5,0.0,1.0,0.0
A04053,2,2,0,4,0.5,0.5,0.0
A04054,0,3,0,3,0.0,1.0,0.0
A04055,2,0,0,2,1.0,0.0,0.0
A04056,2,2,0,4,0.5,0.5,0.0
A04057,8,12,0,20,0.4,0.6,0.0
A04058,4,2,0,6,0.67,0.33,0.0
A04059,0,5,0,5,0.0,1.0,0.0
A04060,0,9,0,9,0.0,1.0,0.0
A04062,1,4,0,5,0.2,0.8,0.0
A04063,0,3,0,3,0.0,1.0,0.0
A04065,0,4,0,4,0.0,1.0,0.0
A04066,0,1,0,1,0.0,1.0,0.0
A04069,7,8,0,15,0.47,0.53,0.0
A04070,0,8,0,8,0.0,1.0,0.0
A04071,0,2,0,2,0.0,1.0,0.0
A04072,0,1,0,1,0.0,1.0,0.0
A04073,2,3,0,5,0.4,0.6,0.0
A04075,0,1,0,1,0.0,1.0,0.0
A04076,4,0,1,5,0.8,0.0,0.2
A04079,0,1,0,1,0.0,1.0,0.0
A04080,1,1,0,2,0.5,0.5,0.0
A04081,4,5,0,9,0.44,0.56,0.0
A04082,0,1,0,1,0.0,1.0,0.0
A04083,4,4,0,8,0.5,0.5,0.0
A04084,1,8,0,9,0.11,0.89,0.0
A04085,1,0,1,2,0.5,0.0,0.5
A04086,0,2,0,2,0.0,1.0,0.0
A04087,6,2,0,8,0.75,0.25,0.0
A04088,2,6,0,8,0.25,0.75,0.0
A04089,0,4,0,4,0.0,1.0,0.0
A04090,0,1,0,1,0.0,1.0,0.0
A04091,1,4,0,5,0.2,0.8,0.0
A04092,0,2,0,2,0.0,1.0,0.0
A04093,0,4,0,4,0.0,1.0,0.0
A04094,0,4,0,4,0.0,1.0,0.0
A04095,1,1,0,2,0.5,0.5,0.0
A04096,5,9,0,14,0.36,0.64,0.0
A04097,1,0,0,1,1.0,0.0,0.0
A04098,9,26,0,35,0.26,0.74,0.0
A04099,6,5,0,11,0.55,0.45,0.0
A04100,0,4,0,4,0.0,1.0,0.0
A04101,0,2,0,2,0.0,1.0,0.0
A04102,10,13,0,23,0.43,0.57,0.0
A04103,1,3,0,4,0.25,0.75,0.0
A04104,5,4,0,9,0.56,0.44,0.0
A04105,8,3,0,11,0.73,0.27,0.0
A04106,0,2,0,2,0.0,1.0,0.0
A04107,1,0,0,1,1.0,0.0,0.0
A04108,17,8,0,25,0.68,0.32,0.0
A04109,1,7,0,8,0.12,0.88,0.0
A04110,0,5,0,5,0.0,1.0,0.0
A04111,7,5,0,12,0.58,0.42,0.0
A04112,1,5,0,6,0.17,0.83,0.0
A04113,0,2,0,2,0.0,1.0,0.0
A04114,4,5,0,9,0.44,0.56,0.0
A04115,0,1,0,1,0.0,1.0,0.0
A04116,3,2,0,5,0.6,0.4,0.0
A04117,0,1,0,1,0.0,1.0,0.0
A04118,4,2,0,6,0.67,0.33,0.0
A04120,2,7,0,9,0.22,0.78,0.0
A04121,4,5,0,9,0.44,0.56,0.0
A04122,0,3,0,3,0.0,1.0,0.0
A04123,0,3,0,3,0.0,1.0,0.0
A04124,1,0,0,1,1.0,0.0,0.0
A04125,1,3,0,4,0.25,0.75,0.0
A04126,4,6,0,10,0.4,0.6,0.0
A04127,3,5,0,8,0.38,0.62,0.0
A04128,0,4,0,4,0.0,1.0,0.0
A04129,0,1,0,1,0.0,1.0,0.0
A04130,3,5,0,8,0.38,0.62,0.0
A04131,1,0,0,1,1.0,0.0,0.0
A04132,2,2,0,4,0.5,0.5,0.0
A04133,1,4,0,5,0.2,0.8,0.0
A04134,0,1,0,1,0.0,1.0,0.0
A04135,4,2,0,6,0.67,0.33,0.0
A04137,5,10,0,15,0.33,0.67,0.0
A04138,0,1,0,1,0.0,1.0,0.0
A04139,4,4,0,8,0.5,0.5,0.0
A04140,18,5,0,23,0.78,0.22,0.0
A04141,1,1,0,2,0.5,0.5,0.0
A04142,3,1,0,4,0.75,0.25,0.0
A04143,0,2,0,2,0.0,1.0,0.0
A04144,3,4,0,7,0.43,0.57,0.0
A04148,9,1,0,10,0.9,0.1,0.0
A04149,0,1,0,1,0.0,1.0,0.0
A04150,0,1,0,1,0.0,1.0,0.0
A04154,1,5,0,6,0.17,0.83,0.0
A04157,1,4,0,5,0.2,0.8,0.0
A04159,2,11,0,13,0.15,0.85,0.0
A04160,0,1,0,1,0.0,1.0,0.0
A04161,1,3,0,4,0.25,0.75,0.0
A04162,12,11,0,23,0.52,0.48,0.0
A04163,3,6,0,9,0.33,0.67,0.0
A04165,0,2,0,2,0.0,1.0,0.0
A04166,4,4,0,8,0.5,0.5,0.0
A04167,1,4,0,5,0.2,0.8,0.0
A04168,6,11,0,17,0.35,0.65,0.0
A04169,1,4,0,5,0.2,0.8,0.0
A04170,6,16,0,22,0.27,0.73,0.0
A04171,1,0,0,1,1.0,0.0,0.0
A04173,1,0,0,1,1.0,0.0,0.0
A04174,10,8,0,18,0.56,0.44,0.0
A04175,0,2,0,2,0.0,1.0,0.0
A04176,0,3,0,3,0.0,1.0,0.0
A04177,0,1,0,1,0.0,1.0,0.0
A04178,2,4,0,6,0.33,0.67,0.0
A04179,2,5,0,7,0.29,0.71,0.0
A04180,2,7,0,9,0.22,0.78,0.0
A04181,2,3,0,5,0.4,0.6,0.0
A04183,1,11,0,12,0.08,0.92,0.0
A04184,10,15,0,25,0.4,0.6,0.0
A04186,0,2,0,2,0.0,1.0,0.0
A04187,2,0,0,2,1.0,0.0,0.0
A04189,4,3,0,7,0.57,0.43,0.0
A04190,1,3,0,4,0.25,0.75,0.0
A04191,4,4,0,8,0.5,0.5,0.0
A04192,0,3,0,3,0.0,1.0,0.0
A04193,3,2,0,5,0.6,0.4,0.0
A04194,5,5,0,10,0.5,0.5,0.0
A04195,0,4,0,4,0.0,1.0,0.0
A04197,1,1,0,2,0.5,0.5,0.0
A04198,9,6,10,25,0.36,0.24,0.4
A04201,0,3,0,3,0.0,1.0,0.0
A04202,2,14,0,16,0.12,0.88,0.0
A04204,0,1,0,1,0.0,1.0,0.0
A04206,1,0,0,1,1.0,0.0,0.0
A04208,0,4,0,4,0.0,1.0,0.0
A04209,3,3,0,6,0.5,0.5,0.0
A04210,1,4,0,5,0.2,0.8,0.0
A04211,1,2,0,3,0.33,0.67,0.0
A04212,5,0,0,5,1.0,0.0,0.0
A04213,0,1,0,1,0.0,1.0,0.0
A04217,20,17,3,40,0.5,0.42,0.07
A04219,0,8,0,8,0.0,1.0,0.0
A04220,1,1,0,2,0.5,0.5,0.0
A04221,1,4,0,5,0.2,0.8,0.0
A04222,2,7,0,9,0.22,0.78,0.0
A04223,1,2,0,3,0.33,0.67,0.0
A04224,1,7,0,8,0.12,0.88,0.0
A04225,0,4,0,4,0.0,1.0,0.0
A04226,0,1,0,1,0.0,1.0,0.0
A04227,2,6,0,8,0.25,0.75,0.0
A04228,3,3,0,6,0.5,0.5,0.0
A04229,0,2,0,2,0.0,1.0,0.0
A04230,1,1,0,2,0.5,0.5,0.0
A04231,5,7,0,12,0.42,0.58,0.0
A04232,1,1,0,2,0.5,0.5,0.0
A04233,3,8,0,11,0.27,0.73,0.0
A04234,1,3,0,4,0.25,0.75,0.0
A04235,0,4,0,4,0.0,1.0,0.0
A04236,0,4,0,4,0.0,1.0,0.0
A04238,2,4,0,6,0.33,0.67,0.0
A04239,1,3,0,4,0.25,0.75,0.0
A04240,14,15,0,29,0.48,0.52,0.0
A04244,4,9,0,13,0.31,0.69,0.0
A04246,1,3,0,4,0.25,0.75,0.0
A04247,3,4,0,7,0.43,0.57,0.0
A04249,1,1,0,2,0.5,0.5,0.0
A04250,1,2,0,3,0.33,0.67,0.0
A04251,2,2,0,4,0.5,0.5,0.0
A04252,2,4,0,6,0.33,0.67,0.0
A04253,0,3,0,3,0.0,1.0,0.0
A04254,4,10,0,14,0.29,0.71,0.0
A04255,2,6,0,8,0.25,0.75,0.0
A04256,0,6,0,6,0.0,1.0,0.0
A04257,2,3,0,5,0.4,0.6,0.0
A04258,0,1,0,1,0.0,1.0,0.0
A04259,1,3,0,4,0.25,0.75,0.0
A04260,6,7,0,13,0.46,0.54,0.0
A04261,1,3,0,4,0.25,0.75,0.0
A04262,0,3,0,3,0.0,1.0,0.0
A04263,0,1,0,1,0.0,1.0,0.0
A04264,5,3,0,8,0.62,0.38,0.0
A04265,1,4,0,5,0.2,0.8,0.0
A04266,1,5,0,6,0.17,0.83,0.0
A04267,1,6,0,7,0.14,0.86,0.0
A04268,1,2,0,3,0.33,0.67,0.0
A04270,2,5,0,7,0.29,0.71,0.0
A04271,0,1,0,1,0.0,1.0,0.0
A04272,4,7,0,11,0.36,0.64,0.0
A04273,3,10,0,13,0.23,0.77,0.0
A04274,1,4,0,5,0.2,0.8,0.0
A04275,0,2,0,2,0.0,1.0,0.0
A04276,0,2,0,2,0.0,1.0,0.0
A04278,2,7,0,9,0.22,0.78,0.0
A04279,16,7,0,23,0.7,0.3,0.0
A04280,5,5,0,10,0.5,0.5,0.0
A04281,3,16,0,19,0.16,0.84,0.0
A04282,0,2,0,2,0.0,1.0,0.0
A04283,3,5,3,11,0.27,0.45,0.27
A04285,0,2,0,2,0.0,1.0,0.0
A04286,3,5,0,8,0.38,0.62,0.0
A04288,3,7,0,10,0.3,0.7,0.0
A04289,4,4,0,8,0.5,0.5,0.0
A04290,1,0,0,1,1.0,0.0,0.0
A04292,1,3,0,4,0.25,0.75,0.0
A04293,4,4,0,8,0.5,0.5,0.0
A04294,3,3,0,6,0.5,0.5,0.0
A04295,7,14,0,21,0.33,0.67,0.0
A04296,1,1,0,2,0.5,0.5,0.0
A04297,0,2,0,2,0.0,1.0,0.0
A04299,7,5,2,14,0.5,0.36,0.14
A04300,1,0,0,1,1.0,0.0,0.0
A04301,0,1,0,1,0.0,1.0,0.0
A04302,0,6,0,6,0.0,1.0,0.0
A04303,2,5,0,7,0.29,0.71,0.0
A04304,0,2,0,2,0.0,1.0,0.0
A04305,5,8,0,13,0.38,0.62,0.0
A04306,3,3,1,7,0.43,0.43,0.14
A04308,1,3,0,4,0.25,0.75,0.0
A04309,0,1,0,1,0.0,1.0,0.0
A04310,6,5,0,11,0.55,0.45,0.0
A04311,1,2,0,3,0.33,0.67,0.0
A04312,0,3,0,3,0.0,1.0,0.0
A04314,3,4,0,7,0.43,0.57,0.0
A04316,7,7,0,14,0.5,0.5,0.0
A04317,0,14,0,14,0.0,1.0,0.0
A04318,3,4,0,7,0.43,0.57,0.0
A04320,1,1,0,2,0.5,0.5,0.0
A04321,0,1,0,1,0.0,1.0,0.0
A04322,3,6,0,9,0.33,0.67,0.0
A04323,1,6,0,7,0.14,0.86,0.0
A04324,1,1,0,2,0.5,0.5,0.0
A04325,0,1,0,1,0.0,1.0,0.0
A04326,6,6,0,12,0.5,0.5,0.0
A04327,3,6,0,9,0.33,0.67,0.0
A04328,2,1,0,3,0.67,0.33,0.0
A04329,5,13,0,18,0.28,0.72,0.0
A04330,5,7,0,12,0.42,0.58,0.0
A04332,6,0,0,6,1.0,0.0,0.0
A04333,0,2,0,2,0.0,1.0,0.0
A04334,5,3,0,8,0.62,0.38,0.0
A04335,6,6,0,12,0.5,0.5,0.0
A04336,1,1,0,2,0.5,0.5,0.0
A04337,17,7,13,37,0.46,0.19,0.35
A04339,0,7,0,7,0.0,1.0,0.0
A04340,0,3,0,3,0.0,1.0,0.0
A04341,3,3,0,6,0.5,0.5,0.0
A04342,4,17,0,21,0.19,0.81,0.0
A04343,0,4,0,4,0.0,1.0,0.0
A04344,7,8,0,15,0.47,0.53,0.0
A04345,1,2,0,3,0.33,0.67,0.0
A04346,3,4,0,7,0.43,0.57,0.0
A04347,3,4,0,7,0.43,0.57,0.0
A04348,0,4,0,4,0.0,1.0,0.0
A04349,0,5,0,5,0.0,1.0,0.0
A04350,1,4,0,5,0.2,0.8,0.0
A04351,2,7,0,9,0.22,0.78,0.0
A04352,6,7,0,13,0.46,0.54,0.0
A04353,2,2,2,6,0.33,0.33,0.33
A04354,8,6,0,14,0.57,0.43,0.0
A04355,1,5,0,6,0.17,0.83,0.0
A04356,0,3,0,3,0.0,1.0,0.0
A04357,0,4,0,4,0.0,1.0,0.0
A04358,1,3,0,4,0.25,0.75,0.0
A04359,0,3,0,3,0.0,1.0,0.0
A04361,0,2,0,2,0.0,1.0,0.0
A04362,1,0,0,1,1.0,0.0,0.0
A04363,4,10,0,14,0.29,0.71,0.0
A04364,1,2,0,3,0.33,0.67,0.0
A04365,1,10,0,11,0.09,0.91,0.0
A04366,1,0,0,1,1.0,0.0,0.0
A04368,0,1,0,1,0.0,1.0,0.0
A04369,2,4,0,6,0.33,0.67,0.0
A04370,6,3,0,9,0.67,0.33,0.0
A04371,4,8,2,14,0.29,0.57,0.14
A04372,0,2,0,2,0.0,1.0,0.0
A04373,2,2,0,4,0.5,0.5,0.0
A04375,0,7,0,7,0.0,1.0,0.0
A04376,1,0,0,1,1.0,0.0,0.0
A04377,0,3,0,3,0.0,1.0,0.0
A04380,1,1,0,2,0.5,0.5,0.0
A04381,0,6,0,6,0.0,1.0,0.0
A04382,4,4,0,8,0.5,0.5,0.0
A04383,2,1,0,3,0.67,0.33,0.0
A04385,0,1,0,1,0.0,1.0,0.0
A04386,2,6,0,8,0.25,0.75,0.0
A04387,4,4,0,8,0.5,0.5,0.0
A04389,1,5,0,6,0.17,0.83,0.0
A04390,3,6,0,9,0.33,0.67,0.0
A04391,2,3,1,6,0.33,0.5,0.17
A04392,0,1,1,2,0.0,0.5,0.5
A04393,2,3,0,5,0.4,0.6,0.0
A04394,2,0,0,2,1.0,0.0,0.0
A04395,0,4,0,4,0.0,1.0,0.0
A04396,14,10,1,25,0.56,0.4,0.04
A04397,0,2,0,2,0.0,1.0,0.0
A04398,9,6,0,15,0.6,0.4,0.0
A04400,4,8,0,12,0.33,0.67,0.0
A04402,3,5,0,8,0.38,0.62,0.0
A04403,1,2,0,3,0.33,0.67,0.0
A04404,3,6,0,9,0.33,0.67,0.0
A04405,0,2,0,2,0.0,1.0,0.0
A04406,1,5,0,6,0.17,0.83,0.0
A04407,0,4,0,4,0.0,1.0,0.0
A04408,5,10,0,15,0.33,0.67,0.0
A04409,0,7,0,7,0.0,1.0,0.0
A04410,1,2,0,3,0.33,0.67,0.0
A04411,0,1,0,1,0.0,1.0,0.0
A04412,0,1,0,1,0.0,1.0,0.0
A04413,1,5,0,6,0.17,0.83,0.0
A04414,5,6,1,12,0.42,0.5,0.08
A04415,0,1,0,1,0.0,1.0,0.0
A04416,5,7,0,12,0.42,0.58,0.0
A04417,0,2,0,2,0.0,1.0,0.0
A04419,3,9,0,12,0.25,0.75,0.0
A04420,0,8,0,8,0.0,1.0,0.0
A04422,0,4,0,4,0.0,1.0,0.0
A04423,1,4,0,5,0.2,0.8,0.0
A04424,0,2,0,2,0.0,1.0,0.0
A04425,3,8,0,11,0.27,0.73,0.0
A04426,0,5,0,5,0.0,1.0,0.0
A04427,1,1,0,2,0.5,0.5,0.0
A04428,2,3,0,5,0.4,0.6,0.0
A04429,0,3,0,3,0.0,1.0,0.0
A04430,10,8,3,21,0.48,0.38,0.14
A04432,2,2,0,4,0.5,0.5,0.0
A04433,8,4,12,24,0.33,0.17,0.5
A04434,0,1,0,1,0.0,1.0,0.0
A04435,2,1,0,3,0.67,0.33,0.0
A04436,1,3,0,4,0.25,0.75,0.0
A04437,1,2,0,3,0.33,0.67,0.0
A04438,3,1,0,4,0.75,0.25,0.0
A04439,3,9,0,12,0.25,0.75,0.0
A04440,1,3,0,4,0.25,0.75,0.0
A04441,2,2,0,4,0.5,0.5,0.0
A04444,3,4,0,7,0.43,0.57,0.0
A04445,0,3,0,3,0.0,1.0,0.0
A04446,1,12,0,13,0.08,0.92,0.0
A04448,3,8,0,11,0.27,0.73,0.0
A04449,1,3,0,4,0.25,0.75,0.0
A04450,0,0,1,1,0.0,0.0,1.0
A04451,2,4,0,6,0.33,0.67,0.0
A04452,0,2,0,2,0.0,1.0,0.0
A04453,2,7,0,9,0.22,0.78,0.0
A04454,0,5,0,5,0.0,1.0,0.0
A04455,0,1,0,1,0.0,1.0,0.0
A04456,3,2,0,5,0.6,0.4,0.0
A04457,9,3,0,12,0.75,0.25,0.0
A04458,0,6,0,6,0.0,1.0,0.0
A04459,4,4,0,8,0.5,0.5,0.0
A04460,0,2,0,2,0.0,1.0,0.0
A04461,2,4,0,6,0.33,0.67,0.0
A04462,0,2,0,2,0.0,1.0,0.0
A04463,2,8,0,10,0.2,0.8,0.0
A04464,2,2,0,4,0.5,0.5,0.0
A04465,3,7,0,10,0.3,0.7,0.0
A04466,1,5,0,6,0.17,0.83,0.0
A04468,18,8,0,26,0.69,0.31,0.0
A04469,2,4,0,6,0.33,0.67,0.0
A04471,0,4,0,4,0.0,1.0,0.0
A04472,0,4,0,4,0.0,1.0,0.0
A04473,1,7,0,8,0.12,0.88,0.0
A04474,0,7,0,7,0.0,1.0,0.0
A04475,2,0,0,2,1.0,0.0,0.0
A04476,0,7,0,7,0.0,1.0,0.0
A04477,12,10,0,22,0.55,0.45,0.0
A04478,2,1,0,3,0.67,0.33,0.0
A04479,1,1,0,2,0.5,0.5,0.0
A04480,0,2,0,2,0.0,1.0,0.0
A04482,0,4,0,4,0.0,1.0,0.0
A04484,2,13,0,15,0.13,0.87,0.0
A04485,2,4,0,6,0.33,0.67,0.0
A04486,0,1,0,1,0.0,1.0,0.0
A04487,0,3,0,3,0.0,1.0,0.0
A04488,27,64,2,93,0.29,0.69,0.02
A04489,12,15,0,27,0.44,0.56,0.0
A04490,2,4,0,6,0.33,0.67,0.0
A04491,4,7,0,11,0.36,0.64,0.0
A04493,0,4,0,4,0.0,1.0,0.0
A04495,3,2,0,5,0.6,0.4,0.0
A04496,1,5,0,6,0.17,0.83,0.0
A04498,4,12,0,16,0.25,0.75,0.0
A04499,0,2,0,2,0.0,1.0,0.0
A04500,4,4,2,10,0.4,0.4,0.2
A04501,4,4,0,8,0.5,0.5,0.0
A04502,1,0,0,1,1.0,0.0,0.0
A04503,0,2,0,2,0.0,1.0,0.0
A04504,5,3,0,8,0.62,0.38,0.0
A04505,2,3,0,5,0.4,0.6,0.0
A04507,1,5,0,6,0.17,0.83,0.0
A04508,4,1,0,5,0.8,0.2,0.0
A04511,0,2,0,2,0.0,1.0,0.0
A04512,0,1,0,1,0.0,1.0,0.0
A04513,1,3,0,4,0.25,0.75,0.0
A04514,0,1,0,1,0.0,1.0,0.0
A04515,3,10,0,13,0.23,0.77,0.0
A04516,0,1,0,1,0.0,1.0,0.0
A04517,8,4,0,12,0.67,0.33,0.0
A04518,0,4,0,4,0.0,1.0,0.0
A04519,5,9,0,14,0.36,0.64,0.0
A04520,0,1,0,1,0.0,1.0,0.0
A04521,0,1,0,1,0.0,1.0,0.0
A04522,1,0,1,2,0.5,0.0,0.5
A04524,3,10,0,13,0.23,0.77,0.0
A04526,1,4,0,5,0.2,0.8,0.0
A04527,1,1,0,2,0.5,0.5,0.0
A04529,0,1,0,1,0.0,1.0,0.0
A04530,0,3,0,3,0.0,1.0,0.0
A04532,0,1,0,1,0.0,1.0,0.0
A04533,6,10,0,16,0.38,0.62,0.0
A04535,0,2,0,2,0.0,1.0,0.0
A04536,0,2,0,2,0.0,1.0,0.0
A04537,4,1,0,5,0.8,0.2,0.0
A04539,1,1,0,2,0.5,0.5,0.0
A04540,0,3,0,3,0.0,1.0,0.0
A04541,2,8,0,10,0.2,0.8,0.0
A04542,1,1,0,2,0.5,0.5,0.0
A04543,3,3,0,6,0.5,0.5,0.0
A04544,3,10,0,13,0.23,0.77,0.0
A04545,0,5,0,5,0.0,1.0,0.0
A04546,2,13,0,15,0.13,0.87,0.0
A04547,1,4,0,5,0.2,0.8,0.0
A04548,4,9,0,13,0.31,0.69,0.0
A04549,4,6,0,10,0.4,0.6,0.0
A04550,0,1,0,1,0.0,1.0,0.0
A04551,0,4,0,4,0.0,1.0,0.0
A04552,0,2,0,2,0.0,1.0,0.0
A04553,12,6,0,18,0.67,0.33,0.0
A04554,2,12,0,14,0.14,0.86,0.0
A04555,2,12,0,14,0.14,0.86,0.0
A04556,2,12,0,14,0.14,0.86,0.0
A04557,4,16,0,20,0.2,0.8,0.0
A04558,11,10,0,21,0.52,0.48,0.0
A04562,0,1,0,1,0.0,1.0,0.0
A04564,2,0,0,2,1.0,0.0,0.0
A04565,0,1,0,1,0.0,1.0,0.0
A04567,1,0,0,1,1.0,0.0,0.0
A04569,7,8,0,15,0.47,0.53,0.0
A04570,1,0,0,1,1.0,0.0,0.0
A04571,0,2,0,2,0.0,1.0,0.0
A04572,0,2,0,2,0.0,1.0,0.0
A04573,1,3,0,4,0.25,0.75,0.0
A04574,0,4,0,4,0.0,1.0,0.0
A04575,1,1,0,2,0.5,0.5,0.0
A04582,2,3,1,6,0.33,0.5,0.17
A04584,0,1,0,1,0.0,1.0,0.0
A04586,0,1,0,1,0.0,1.0,0.0
A04588,1,1,0,2,0.5,0.5,0.0
A04589,0,1,0,1,0.0,1.0,0.0
A04590,0,5,0,5,0.0,1.0,0.0
A04591,1,1,0,2,0.5,0.5,0.0
A04594,0,2,0,2,0.0,1.0,0.0
A04597,2,3,0,5,0.4,0.6,0.0
A04605,2,2,0,4,0.5,0.5,0.0
A04609,0,1,0,1,0.0,1.0,0.0
A04614,2,4,0,6,0.33,0.67,0.0
A04616,4,4,0,8,0.5,0.5,0.0
A04617,2,4,0,6,0.33,0.67,0.0
A04622,0,3,0,3,0.0,1.0,0.0
A04623,4,8,0,12,0.33,0.67,0.0
A04625,1,0,0,1,1.0,0.0,0.0
A04626,0,1,0,1,0.0,1.0,0.0
A04630,0,5,0,5,0.0,1.0,0.0
A04632,0,1,0,1,0.0,1.0,0.0
A04633,0,3,0,3,0.0,1.0,0.0
A04634,0,1,0,1,0.0,1.0,0.0
A04641,2,1,0,3,0.67,0.33,0.0
A04642,0,3,0,3,0.0,1.0,0.0
A04643,0,1,0,1,0.0,1.0,0.0
A04646,0,1,0,1,0.0,1.0,0.0
A04648,0,3,0,3,0.0,1.0,0.0
A04649,0,2,0,2,0.0,1.0,0.0
A04650,7,6,0,13,0.54,0.46,0.0
A04651,0,2,0,2,0.0,1.0,0.0
A04655,12,1,0,13,0.92,0.08,0.0
A04657,0,2,0,2,0.0,1.0,0.0
A04658,0,1,0,1,0.0,1.0,0.0
A04660,3,7,0,10,0.3,0.7,0.0
A04664,1,0,0,1,1.0,0.0,0.0
A04665,3,3,0,6,0.5,0.5,0.0
A04666,0,1,0,1,0.0,1.0,0.0
A04667,1,2,0,3,0.33,0.67,0.0
A04672,1,0,0,1,1.0,0.0,0.0
A04674,0,1,0,1,0.0,1.0,0.0
A04676,1,2,0,3,0.33,0.67,0.0
A04677,0,1,0,1,0.0,1.0,0.0
A04679,2,4,0,6,0.33,0.67,0.0
A04682,2,4,0,6,0.33,0.67,0.0
A04683,0,1,0,1,0.0,1.0,0.0
A04685,0,1,0,1,0.0,1.0,0.0
A04686,0,1,0,1,0.0,1.0,0.0
A04687,0,2,0,2,0.0,1.0,0.0
A04688,2,4,0,6,0.33,0.67,0.0
A04693,2,3,0,5,0.4,0.6,0.0
A04694,1,2,0,3,0.33,0.67,0.0
A04695,1,1,0,2,0.5,0.5,0.0
A04697,2,1,0,3,0.67,0.33,0.0
A04699,1,1,0,2,0.5,0.5,0.0
A04703,2,1,0,3,0.67,0.33,0.0
A04706,0,2,0,2,0.0,1.0,0.0
A04709,0,4,0,4,0.0,1.0,0.0
A04710,1,2,0,3,0.33,0.67,0.0
A04711,4,0,0,4,1.0,0.0,0.0
A04714,1,3,0,4,0.25,0.75,0.0
A04715,4,2,0,6,0.67,0.33,0.0
A04716,1,2,0,3,0.33,0.67,0.0
A04717,1,1,0,2,0.5,0.5,0.0
A04725,0,3,0,3,0.0,1.0,0.0
A04726,1,1,0,2,0.5,0.5,0.0
A04727,4,6,0,10,0.4,0.6,0.0
A04729,1,2,0,3,0.33,0.67,0.0
A04730,1,3,0,4,0.25,0.75,0.0
A04734,0,3,0,3,0.0,1.0,0.0
A04735,0,1,0,1,0.0,1.0,0.0
A04740,0,1,0,1,0.0,1.0,0.0
A04743,0,1,0,1,0.0,1.0,0.0
A04744,1,3,0,4,0.25,0.75,0.0
A04749,0,3,0,3,0.0,1.0,0.0
A04750,0,1,0,1,0.0,1.0,0.0
A04752,2,1,0,3,0.67,0.33,0.0
A04755,0,2,0,2,0.0,1.0,0.0
A04758,0,3,0,3,0.0,1.0,0.0
A04765,0,1,0,1,0.0,1.0,0.0
A04766,0,1,0,1,0.0,1.0,0.0
A04767,1,2,0,3,0.33,0.67,0.0
A04768,0,1,0,1,0.0,1.0,0.0
A04769,2,13,0,15,0.13,0.87,0.0
A04771,19,8,0,27,0.7,0.3,0.0
A04772,2,4,0,6,0.33,0.67,0.0
A04773,4,8,0,12,0.33,0.67,0.0
A04774,0,1,0,1,0.0,1.0,0.0
A04775,3,4,0,7,0.43,0.57,0.0
A04776,2,8,0,10,0.2,0.8,0.0
A04777,2,4,0,6,0.33,0.67,0.0
A04779,2,6,0,8,0.25,0.75,0.0
A04780,0,3,0,3,0.0,1.0,0.0
A04781,0,2,0,2,0.0,1.0,0.0
A04782,0,2,0,2,0.0,1.0,0.0
A04783,1,2,0,3,0.33,0.67,0.0
A04785,0,7,0,7,0.0,1.0,0.0
A04786,2,3,0,5,0.4,0.6,0.0
A04787,1,2,0,3,0.33,0.67,0.0
A04788,2,6,0,8,0.25,0.75,0.0
A04790,0,3,0,3,0.0,1.0,0.0
A04791,0,1,0,1,0.0,1.0,0.0
A04792,8,8,3,19,0.42,0.42,0.16
A04793,4,10,0,14,0.29,0.71,0.0
A04794,0,4,0,4,0.0,1.0,0.0
A04795,2,10,1,13,0.15,0.77,0.08
A04796,3,1,0,4,0.75,0.25,0.0
A04797,1,10,0,11,0.09,0.91,0.0
A04798,0,1,0,1,0.0,1.0,0.0
A04800,0,3,0,3,0.0,1.0,0.0
A04801,2,3,0,5,0.4,0.6,0.0
A04802,1,3,0,4,0.25,0.75,0.0
A04803,0,2,0,2,0.0,1.0,0.0
A04804,0,4,0,4,0.0,1.0,0.0
A04805,1,7,0,8,0.12,0.88,0.0
A04806,2,2,0,4,0.5,0.5,0.0
A04807,0,3,0,3,0.0,1.0,0.0
A04808,2,3,0,5,0.4,0.6,0.0
A04809,3,6,0,9,0.33,0.67,0.0
A04810,1,10,0,11,0.09,0.91,0.0
A04812,1,19,0,20,0.05,0.95,0.0
A04813,0,1,0,1,0.0,1.0,0.0
A04814,0,5,0,5,0.0,1.0,0.0
A04815,0,1,0,1,0.0,1.0,0.0
A04816,1,3,0,4,0.25,0.75,0.0
A04817,0,3,0,3,0.0,1.0,0.0
A04818,0,5,0,5,0.0,1.0,0.0
A04819,1,4,0,5,0.2,0.8,0.0
A04820,0,4,0,4,0.0,1.0,0.0
A04821,2,1,0,3,0.67,0.33,0.0
A04822,2,3,0,5,0.4,0.6,0.0
A04824,4,4,0,8,0.5,0.5,0.0
A04826,1,0,0,1,1.0,0.0,0.0
A04827,3,9,0,12,0.25,0.75,0.0
A04829,2,2,0,4,0.5,0.5,0.0
A04830,2,1,0,3,0.67,0.33,0.0
A04831,7,16,0,23,0.3,0.7,0.0
A04832,3,4,0,7,0.43,0.57,0.0
A04834,1,7,0,8,0.12,0.88,0.0
A04836,2,1,0,3,0.67,0.33,0.0
A04837,0,4,0,4,0.0,1.0,0.0
A04838,2,1,0,3,0.67,0.33,0.0
A04839,4,4,0,8,0.5,0.5,0.0
A04841,1,4,0,5,0.2,0.8,0.0
A04842,6,7,0,13,0.46,0.54,0.0
A04844,0,2,0,2,0.0,1.0,0.0
A04845,5,5,0,10,0.5,0.5,0.0
A04846,0,1,0,1,0.0,1.0,0.0
A04848,1,3,0,4,0.25,0.75,0.0
A04849,1,4,0,5,0.2,0.8,0.0
A04850,4,3,0,7,0.57,0.43,0.0
A04851,4,3,0,7,0.57,0.43,0.0
A04853,3,5,0,8,0.38,0.62,0.0
A04856,1,4,0,5,0.2,0.8,0.0
A04857,0,3,0,3,0.0,1.0,0.0
A04858,2,35,0,37,0.05,0.95,0.0
A04859,0,2,0,2,0.0,1.0,0.0
A04860,7,16,0,23,0.3,0.7,0.0
A04861,0,3,0,3,0.0,1.0,0.0
A04862,1,9,0,10,0.1,0.9,0.0
A04867,4,8,0,12,0.33,0.67,0.0
A04868,8,21,0,29,0.28,0.72,0.0
A04869,1,4,0,5,0.2,0.8,0.0
A04870,5,4,0,9,0.56,0.44,0.0
A04871,1,4,0,5,0.2,0.8,0.0
A04872,0,3,0,3,0.0,1.0,0.0
A04873,0,3,0,3,0.0,1.0,0.0
A04877,0,1,0,1,0.0,1.0,0.0
A04878,0,1,0,1,0.0,1.0,0.0
A04879,1,4,0,5,0.2,0.8,0.0
A04882,2,0,0,2,1.0,0.0,0.0
A04883,1,0,0,1,1.0,0.0,0.0
A04884,2,1,1,4,0.5,0.25,0.25
A04885,5,11,0,16,0.31,0.69,0.0
A04886,1,10,0,11,0.09,0.91,0.0
A04888,0,1,0,1,0.0,1.0,0.0
A04889,1,8,0,9,0.11,0.89,0.0
A04890,7,29,0,36,0.19,0.81,0.0
A04891,11,10,0,21,0.52,0.48,0.0
A04892,4,4,0,8,0.5,0.5,0.0
A04894,0,1,0,1,0.0,1.0,0.0
A04897,2,3,0,5,0.4,0.6,0.0
A04899,0,3,0,3,0.0,1.0,0.0
A04901,0,4,0,4,0.0,1.0,0.0
A04905,3,11,0,14,0.21,0.79,0.0
A04906,0,2,0,2,0.0,1.0,0.0
A04907,5,9,0,14,0.36,0.64,0.0
A04910,0,2,0,2,0.0,1.0,0.0
A04911,0,1,0,1,0.0,1.0,0.0
A04912,0,2,0,2,0.0,1.0,0.0
A04914,0,2,0,2,0.0,1.0,0.0
A04915,4,10,0,14,0.29,0.71,0.0
A04916,0,4,0,4,0.0,1.0,0.0
A04917,1,1,0,2,0.5,0.5,0.0
A04919,1,9,0,10,0.1,0.9,0.0
A04923,4,16,0,20,0.2,0.8,0.0
A04925,6,4,0,10,0.6,0.4,0.0
A04926,2,11,0,13,0.15,0.85,0.0
A04927,2,7,0,9,0.22,0.78,0.0
A04928,2,1,0,3,0.67,0.33,0.0
A04929,0,5,0,5,0.0,1.0,0.0
A04930,1,2,0,3,0.33,0.67,0.0
A04931,0,1,0,1,0.0,1.0,0.0
A04932,3,6,0,9,0.33,0.67,0.0
A04933,0,1,0,1,0.0,1.0,0.0
A04934,0,2,0,2,0.0,1.0,0.0
A04935,0,3,0,3,0.0,1.0,0.0
A04936,3,0,0,3,1.0,0.0,0.0
A04937,2,8,0,10,0.2,0.8,0.0
A04938,0,2,0,2,0.0,1.0,0.0
A04939,2,0,0,2,1.0,0.0,0.0
A04940,1,0,0,1,1.0,0.0,0.0
A04941,8,6,0,14,0.57,0.43,0.0
A04942,0,3,0,3,0.0,1.0,0.0
A04944,3,7,0,10,0.3,0.7,0.0
A04946,5,22,0,27,0.19,0.81,0.0
A04947,0,3,0,3,0.0,1.0,0.0
A04948,1,2,0,3,0.33,0.67,0.0
A04949,4,5,0,9,0.44,0.56,0.0
A04950,0,1,0,1,0.0,1.0,0.0
A04951,0,3,0,3,0.0,1.0,0.0
A04953,4,9,0,13,0.31,0.69,0.0
A04954,2,2,0,4,0.5,0.5,0.0
A04956,1,0,0,1,1.0,0.0,0.0
A04957,0,1,0,1,0.0,1.0,0.0
A04958,1,3,0,4,0.25,0.75,0.0
A04959,3,7,0,10,0.3,0.7,0.0
A04960,1,3,0,4,0.25,0.75,0.0
A04961,12,24,0,36,0.33,0.67,0.0
A04963,2,4,0,6,0.33,0.67,0.0
A04964,8,11,0,19,0.42,0.58,0.0
A04965,1,2,0,3,0.33,0.67,0.0
A04966,2,1,0,3,0.67,0.33,0.0
A04967,1,6,0,7,0.14,0.86,0.0
A04968,0,1,0,1,0.0,1.0,0.0
A04969,0,2,0,2,0.0,1.0,0.0
A04970,7,6,0,13,0.54,0.46,0.0
A04971,7,6,0,13,0.54,0.46,0.0
A04976,0,3,0,3,0.0,1.0,0.0
A04978,2,7,0,9,0.22,0.78,0.0
A04980,0,3,0,3,0.0,1.0,0.0
A04983,0,1,0,1,0.0,1.0,0.0
A04985,4,4,0,8,0.5,0.5,0.0
A04987,9,3,0,12,0.75,0.25,0.0
A04988,3,3,0,6,0.5,0.5,0.0
A04989,0,3,0,3,0.0,1.0,0.0
A04990,3,2,0,5,0.6,0.4,0.0
A04991,0,8,0,8,0.0,1.0,0.0
A04992,4,3,0,7,0.57,0.43,0.0
A04993,3,5,0,8,0.38,0.62,0.0
A04994,0,1,0,1,0.0,1.0,0.0
A04995,0,5,1,6,0.0,0.83,0.17
A04996,0,5,0,5,0.0,1.0,0.0
A04997,0,11,0,11,0.0,1.0,0.0
A04998,0,2,0,2,0.0,1.0,0.0
A04999,1,0,0,1,1.0,0.0,0.0
A05001,3,2,0,5,0.6,0.4,0.0
A05002,1,2,0,3,0.33,0.67,0.0
A05003,6,10,0,16,0.38,0.62,0.0
A05004,0,2,0,2,0.0,1.0,0.0
A05005,0,1,0,1,0.0,1.0,0.0
A05006,11,9,0,20,0.55,0.45,0.0
A05008,1,3,0,4,0.25,0.75,0.0
A05010,0,3,0,3,0.0,1.0,0.0
A05014,0,1,0,1,0.0,1.0,0.0
A05018,0,4,0,4,0.0,1.0,0.0
A05019,1,11,0,12,0.08,0.92,0.0
A05022,3,11,0,14,0.21,0.79,0.0
A05023,0,2,0,2,0.0,1.0,0.0
A05024,1,4,0,5,0.2,0.8,0.0
A05026,7,31,0,38,0.18,0.82,0.0
A05027,3,8,0,11,0.27,0.73,0.0
A05028,1,1,0,2,0.5,0.5,0.0
A05029,0,4,0,4,0.0,1.0,0.0
A05030,1,3,0,4,0.25,0.75,0.0
A05031,3,2,0,5,0.6,0.4,0.0
A05032,0,2,0,2,0.0,1.0,0.0
A05036,2,6,0,8,0.25,0.75,0.0
A05039,0,2,0,2,0.0,1.0,0.0
A05042,4,11,0,15,0.27,0.73,0.0
A05043,2,4,0,6,0.33,0.67,0.0
A05044,1,3,0,4,0.25,0.75,0.0
A05045,1,0,0,1,1.0,0.0,0.0
A05049,0,1,0,1,0.0,1.0,0.0
A05050,0,3,0,3,0.0,1.0,0.0
A05052,0,1,0,1,0.0,1.0,0.0
A05053,6,7,0,13,0.46,0.54,0.0
A05054,1,15,0,16,0.06,0.94,0.0
A05055,0,3,0,3,0.0,1.0,0.0
A05056,1,11,0,12,0.08,0.92,0.0
A05057,0,4,0,4,0.0,1.0,0.0
A05058,2,3,0,5,0.4,0.6,0.0
A05059,3,0,0,3,1.0,0.0,0.0
A05060,0,4,0,4,0.0,1.0,0.0
A05061,5,3,0,8,0.62,0.38,0.0
A05062,0,3,0,3,0.0,1.0,0.0
A05063,3,5,0,8,0.38,0.62,0.0
A05064,1,1,0,2,0.5,0.5,0.0
A05065,0,13,0,13,0.0,1.0,0.0
A05066,2,8,0,10,0.2,0.8,0.0
A05067,0,3,0,3,0.0,1.0,0.0
A05071,2,5,0,7,0.29,0.71,0.0
A05072,1,4,0,5,0.2,0.8,0.0
A05073,0,1,0,1,0.0,1.0,0.0
A05075,4,6,0,10,0.4,0.6,0.0
A05078,0,2,0,2,0.0,1.0,0.0
A05080,1,4,0,5,0.2,0.8,0.0
A05082,4,13,0,17,0.24,0.76,0.0
A05083,3,3,0,6,0.5,0.5,0.0
A05084,1,0,0,1,1.0,0.0,0.0
A05085,0,1,0,1,0.0,1.0,0.0
A05086,2,6,0,8,0.25,0.75,0.0
A05087,3,9,0,12,0.25,0.75,0.0
A05089,0,5,0,5,0.0,1.0,0.0
A05091,0,1,0,1,0.0,1.0,0.0
A05092,1,1,0,2,0.5,0.5,0.0
A05093,4,2,0,6,0.67,0.33,0.0
A05094,0,2,0,2,0.0,1.0,0.0
A05096,0,1,0,1,0.0,1.0,0.0
A05097,1,4,0,5,0.2,0.8,0.0
A05100,8,18,0,26,0.31,0.69,0.0
A05101,18,6,0,24,0.75,0.25,0.0
A05102,0,1,0,1,0.0,1.0,0.0
A05103,0,5,0,5,0.0,1.0,0.0
A05104,6,6,0,12,0.5,0.5,0.0
A05105,2,7,0,9,0.22,0.78,0.0
A05106,4,7,0,11,0.36,0.64,0.0
A05107,4,7,0,11,0.36,0.64,0.0
A05108,0,2,0,2,0.0,1.0,0.0
A05109,3,8,0,11,0.27,0.73,0.0
A05110,3,8,0,11,0.27,0.73,0.0
A05111,2,4,0,6,0.33,0.67,0.0
A05113,0,8,0,8,0.0,1.0,0.0
A05114,3,3,0,6,0.5,0.5,0.0
A05115,1,1,1,3,0.33,0.33,0.33
A05116,2,2,0,4,0.5,0.5,0.0
A05117,3,2,0,5,0.6,0.4,0.0
A05118,0,3,0,3,0.0,1.0,0.0
A05119,0,4,0,4,0.0,1.0,0.0
A05121,0,2,0,2,0.0,1.0,0.0
A05122,3,11,0,14,0.21,0.79,0.0
A05123,1,5,0,6,0.17,0.83,0.0
A05125,2,2,0,4,0.5,0.5,0.0
A05126,3,7,0,10,0.3,0.7,0.0
A05127,2,4,0,6,0.33,0.67,0.0
A05128,0,7,0,7,0.0,1.0,0.0
A05129,1,4,0,5,0.2,0.8,0.0
A05131,0,1,0,1,0.0,1.0,0.0
A05132,0,1,0,1,0.0,1.0,0.0
A05133,0,2,0,2,0.0,1.0,0.0
A05134,1,9,0,10,0.1,0.9,0.0
A05135,4,14,0,18,0.22,0.78,0.0
A05136,2,1,0,3,0.67,0.33,0.0
A05137,1,4,0,5,0.2,0.8,0.0
A05138,0,1,0,1,0.0,1.0,0.0
A05139,8,12,0,20,0.4,0.6,0.0
A05141,0,3,0,3,0.0,1.0,0.0
A05142,0,5,0,5,0.0,1.0,0.0
A05143,5,29,0,34,0.15,0.85,0.0
A05145,2,4,0,6,0.33,0.67,0.0
A05146,2,8,0,10,0.2,0.8,0.0
A05148,0,3,0,3,0.0,1.0,0.0
A05149,1,1,0,2,0.5,0.5,0.0
A05150,0,1,0,1,0.0,1.0,0.0
A05151,2,4,0,6,0.33,0.67,0.0
A05153,2,3,0,5,0.4,0.6,0.0
A05154,1,0,0,1,1.0,0.0,0.0
A05155,0,1,0,1,0.0,1.0,0.0
A05157,1,9,0,10,0.1,0.9,0.0
A05158,0,5,0,5,0.0,1.0,0.0
A05159,0,2,0,2,0.0,1.0,0.0
A05160,1,2,0,3,0.33,0.67,0.0
A05161,1,0,0,1,1.0,0.0,0.0
A05163,5,19,0,24,0.21,0.79,0.0
A05164,2,5,0,7,0.29,0.71,0.0
A05165,3,6,0,9,0.33,0.67,0.0
A05167,0,1,0,1,0.0,1.0,0.0
A05169,0,2,0,2,0.0,1.0,0.0
A05170,10,12,0,22,0.45,0.55,0.0
A05171,1,4,0,5,0.2,0.8,0.0
A05172,6,1,0,7,0.86,0.14,0.0
A05173,1,2,0,3,0.33,0.67,0.0
A05174,0,2,0,2,0.0,1.0,0.0
A05175,0,5,0,5,0.0,1.0,0.0
A05176,0,1,0,1,0.0,1.0,0.0
A05178,6,26,0,32,0.19,0.81,0.0
A05179,0,5,0,5,0.0,1.0,0.0
A05180,2,0,0,2,1.0,0.0,0.0
A05181,0,2,0,2,0.0,1.0,0.0
A05182,2,2,0,4,0.5,0.5,0.0
A05183,1,4,0,5,0.2,0.8,0.0
A05184,20,13,31,64,0.31,0.2,0.48
A05185,0,1,0,1,0.0,1.0,0.0
A05186,11,21,1,33,0.33,0.64,0.03
A05187,9,7,1,17,0.53,0.41,0.06
A05188,2,2,0,4,0.5,0.5,0.0
A05189,3,2,0,5,0.6,0.4,0.0
A05190,1,2,0,3,0.33,0.67,0.0
A05193,3,1,0,4,0.75,0.25,0.0
A05194,0,8,0,8,0.0,1.0,0.0
A05195,1,7,0,8,0.12,0.88,0.0
A05196,0,4,0,4,0.0,1.0,0.0
A05197,2,4,0,6,0.33,0.67,0.0
A05198,2,76,0,78,0.03,0.97,0.0
A05199,4,3,0,7,0.57,0.43,0.0
A05200,0,5,0,5,0.0,1.0,0.0
A05201,4,2,0,6,0.67,0.33,0.0
A05202,3,6,0,9,0.33,0.67,0.0
A05203,1,11,0,12,0.08,0.92,0.0
A05204,1,3,0,4,0.25,0.75,0.0
A05205,4,7,0,11,0.36,0.64,0.0
A05206,1,5,0,6,0.17,0.83,0.0
A05207,2,2,0,4,0.5,0.5,0.0
A05209,12,24,3,39,0.31,0.62,0.08
A05210,8,14,0,22,0.36,0.64,0.0
A05211,3,1,0,4,0.75,0.25,0.0
A05213,13,5,0,18,0.72,0.28,0.0
A05214,5,2,0,7,0.71,0.29,0.0
A05215,1,0,0,1,1.0,0.0,0.0
A05216,0,5,0,5,0.0,1.0,0.0
A05217,0,6,0,6,0.0,1.0,0.0
A05218,1,3,0,4,0.25,0.75,0.0
A05219,0,3,0,3,0.0,1.0,0.0
A05221,6,32,0,38,0.16,0.84,0.0
A05222,6,2,17,25,0.24,0.08,0.68
A05223,7,16,0,23,0.3,0.7,0.0
A05225,1,5,0,6,0.17,0.83,0.0
A05227,1,1,0,2,0.5,0.5,0.0
A05229,1,0,0,1,1.0,0.0,0.0
A05230,6,23,0,29,0.21,0.79,0.0
A05231,1,7,0,8,0.12,0.88,0.0
A05232,2,3,0,5,0.4,0.6,0.0
A05233,3,3,0,6,0.5,0.5,0.0
A05234,11,9,0,20,0.55,0.45,0.0
A05235,2,2,0,4,0.5,0.5,0.0
A05236,4,7,0,11,0.36,0.64,0.0
A05237,12,26,0,38,0.32,0.68,0.0
A05238,5,4,0,9,0.56,0.44,0.0
A05239,1,4,0,5,0.2,0.8,0.0
A05240,0,2,0,2,0.0,1.0,0.0
A05241,1,3,0,4,0.25,0.75,0.0
A05242,2,5,0,7,0.29,0.71,0.0
A05243,1,3,0,4,0.25,0.75,0.0
A05244,3,14,5,22,0.14,0.64,0.23
A05245,0,6,0,6,0.0,1.0,0.0
A05246,2,8,0,10,0.2,0.8,0.0
A05247,7,6,0,13,0.54,0.46,0.0
A05248,1,1,0,2,0.5,0.5,0.0
A05249,1,5,0,6,0.17,0.83,0.0
A05250,7,7,1,15,0.47,0.47,0.07
A05251,1,1,0,2,0.5,0.5,0.0
A05252,0,4,0,4,0.0,1.0,0.0
A05253,12,11,0,23,0.52,0.48,0.0
A05255,7,3,0,10,0.7,0.3,0.0
A05256,2,15,0,17,0.12,0.88,0.0
A05258,1,1,0,2,0.5,0.5,0.0
A05259,0,3,0,3,0.0,1.0,0.0
A05260,5,10,0,15,0.33,0.67,0.0
A05261,0,1,0,1,0.0,1.0,0.0
A05262,1,9,0,10,0.1,0.9,0.0
A05263,1,7,0,8,0.12,0.88,0.0
A05264,2,4,0,6,0.33,0.67,0.0
A05265,0,4,0,4,0.0,1.0,0.0
A05266,10,11,0,21,0.48,0.52,0.0
A05267,9,7,0,16,0.56,0.44,0.0
A05268,3,4,0,7,0.43,0.57,0.0
A05269,2,6,0,8,0.25,0.75,0.0
A05270,6,1,2,9,0.67,0.11,0.22
A05271,13,11,0,24,0.54,0.46,0.0
A05272,2,1,0,3,0.67,0.33,0.0
A05273,7,8,0,15,0.47,0.53,0.0
A05274,0,4,0,4,0.0,1.0,0.0
A05275,0,2,0,2,0.0,1.0,0.0
A05276,7,3,0,10,0.7,0.3,0.0
A05277,0,2,0,2,0.0,1.0,0.0
A05278,5,0,0,5,1.0,0.0,0.0
A05279,1,3,0,4,0.25,0.75,0.0
A05280,0,4,0,4,0.0,1.0,0.0
A05281,6,17,0,23,0.26,0.74,0.0
A05282,2,5,0,7,0.29,0.71,0.0
A05283,0,1,0,1,0.0,1.0,0.0
A05284,9,7,0,16,0.56,0.44,0.0
A05285,4,6,0,10,0.4,0.6,0.0
A05286,0,3,0,3,0.0,1.0,0.0
A05288,1,2,0,3,0.33,0.67,0.0
A05289,1,2,1,4,0.25,0.5,0.25
A05290,6,14,0,20,0.3,0.7,0.0
A05291,2,13,0,15,0.13,0.87,0.0
A05292,1,4,0,5,0.2,0.8,0.0
A05293,2,7,0,9,0.22,0.78,0.0
A05294,1,1,0,2,0.5,0.5,0.0
A05295,1,5,0,6,0.17,0.83,0.0
A05296,0,2,0,2,0.0,1.0,0.0
A05297,1,5,0,6,0.17,0.83,0.0
A05298,2,10,0,12,0.17,0.83,0.0
A05299,0,2,0,2,0.0,1.0,0.0
A05300,3,2,0,5,0.6,0.4,0.0
A05301,2,4,0,6,0.33,0.67,0.0
A05303,4,10,0,14,0.29,0.71,0.0
A05304,0,2,0,2,0.0,1.0,0.0
A05305,10,23,0,33,0.3,0.7,0.0
A05306,1,1,0,2,0.5,0.5,0.0
A05307,1,3,0,4,0.25,0.75,0.0
A05309,1,1,0,2,0.5,0.5,0.0
A05310,5,12,0,17,0.29,0.71,0.0
A05311,6,7,0,13,0.46,0.54,0.0
A05312,8,6,0,14,0.57,0.43,0.0
A05313,4,10,0,14,0.29,0.71,0.0
A05314,0,1,0,1,0.0,1.0,0.0
A05315,0,3,0,3,0.0,1.0,0.0
A05316,0,1,0,1,0.0,1.0,0.0
A05317,0,3,0,3,0.0,1.0,0.0
A05318,0,4,0,4,0.0,1.0,0.0
A05319,1,8,0,9,0.11,0.89,0.0
A05320,0,8,0,8,0.0,1.0,0.0
A05322,12,14,0,26,0.46,0.54,0.0
A05323,0,1,0,1,0.0,1.0,0.0
A05324,2,2,0,4,0.5,0.5,0.0
A05325,1,6,0,7,0.14,0.86,0.0
A05326,4,3,0,7,0.57,0.43,0.0
A05327,1,7,0,8,0.12,0.88,0.0
A05328,0,3,0,3,0.0,1.0,0.0
A05329,0,4,0,4,0.0,1.0,0.0
A05330,0,1,0,1,0.0,1.0,0.0
A05331,0,1,0,1,0.0,1.0,0.0
A05332,0,1,0,1,0.0,1.0,0.0
A05333,0,4,0,4,0.0,1.0,0.0
A05334,0,1,0,1,0.0,1.0,0.0
A05335,2,13,0,15,0.13,0.87,0.0
A05336,0,6,0,6,0.0,1.0,0.0
A05337,1,8,0,9,0.11,0.89,0.0
A05338,6,4,5,15,0.4,0.27,0.33
A05339,2,6,0,8,0.25,0.75,0.0
A05340,4,9,0,13,0.31,0.69,0.0
A05341,0,3,0,3,0.0,1.0,0.0
A05342,2,31,0,33,0.06,0.94,0.0
A05343,0,1,0,1,0.0,1.0,0.0
A05344,0,2,0,2,0.0,1.0,0.0
A05345,13,25,3,41,0.32,0.61,0.07
A05346,1,0,0,1,1.0,0.0,0.0
A05348,1,3,0,4,0.25,0.75,0.0
A05349,0,1,0,1,0.0,1.0,0.0
A05350,8,9,0,17,0.47,0.53,0.0
A05351,8,11,0,19,0.42,0.58,0.0
A05352,3,4,0,7,0.43,0.57,0.0
A05353,3,4,0,7,0.43,0.57,0.0
A05355,4,8,0,12,0.33,0.67,0.0
A05356,13,10,0,23,0.57,0.43,0.0
A05357,8,7,0,15,0.53,0.47,0.0
A05358,8,2,0,10,0.8,0.2,0.0
A05359,6,7,0,13,0.46,0.54,0.0
A05360,1,0,0,1,1.0,0.0,0.0
A05361,0,1,0,1,0.0,1.0,0.0
A05363,1,1,0,2,0.5,0.5,0.0
A05364,4,1,0,5,0.8,0.2,0.0
A05365,5,4,0,9,0.56,0.44,0.0
A05367,0,1,0,1,0.0,1.0,0.0
A05368,4,8,0,12,0.33,0.67,0.0
A05369,1,1,0,2,0.5,0.5,0.0
A05370,0,5,0,5,0.0,1.0,0.0
A05371,2,4,0,6,0.33,0.67,0.0
A05372,3,8,0,11,0.27,0.73,0.0
A05373,10,8,2,20,0.5,0.4,0.1
A05375,1,5,0,6,0.17,0.83,0.0
A05376,1,4,0,5,0.2,0.8,0.0
A05379,6,4,0,10,0.6,0.4,0.0
A05381,2,1,0,3,0.67,0.33,0.0
A05382,0,1,0,1,0.0,1.0,0.0
A05383,2,8,0,10,0.2,0.8,0.0
A05384,0,1,0,1,0.0,1.0,0.0
A05385,4,3,0,7,0.57,0.43,0.0
A05387,1,6,0,7,0.14,0.86,0.0
A05388,2,7,0,9,0.22,0.78,0.0
A05389,2,5,0,7,0.29,0.71,0.0
A05390,2,0,0,2,1.0,0.0,0.0
A05391,0,3,0,3,0.0,1.0,0.0
A05392,5,9,0,14,0.36,0.64,0.0
A05393,13,9,0,22,0.59,0.41,0.0
A05394,22,20,0,42,0.52,0.48,0.0
A05395,5,14,0,19,0.26,0.74,0.0
A05397,0,6,0,6,0.0,1.0,0.0
A05398,3,4,0,7,0.43,0.57,0.0
A05399,26,9,0,35,0.74,0.26,0.0
A05400,4,7,0,11,0.36,0.64,0.0
A05401,7,1,0,8,0.88,0.12,0.0
A05402,20,6,0,26,0.77,0.23,0.0
A05403,6,11,0,17,0.35,0.65,0.0
A05405,2,5,0,7,0.29,0.71,0.0
A05407,2,10,0,12,0.17,0.83,0.0
A05408,1,5,0,6,0.17,0.83,0.0
A05410,0,2,0,2,0.0,1.0,0.0
A05411,0,4,0,4,0.0,1.0,0.0
A05412,0,1,0,1,0.0,1.0,0.0
A05414,8,21,0,29,0.28,0.72,0.0
A05416,9,19,0,28,0.32,0.68,0.0
A05418,0,5,0,5,0.0,1.0,0.0
A05419,14,13,0,27,0.52,0.48,0.0
A05420,0,1,0,1,0.0,1.0,0.0
A05421,0,20,0,20,0.0,1.0,0.0
A05422,4,8,0,12,0.33,0.67,0.0
A05423,2,2,0,4,0.5,0.5,0.0
A05425,1,7,0,8,0.12,0.88,0.0
A05426,2,2,0,4,0.5,0.5,0.0
A05427,1,10,0,11,0.09,0.91,0.0
A05428,0,5,0,5,0.0,1.0,0.0
A05429,0,3,0,3,0.0,1.0,0.0
A05430,1,6,0,7,0.14,0.86,0.0
A05431,0,4,0,4,0.0,1.0,0.0
A05432,5,8,0,13,0.38,0.62,0.0
A05433,10,12,0,22,0.45,0.55,0.0
A05435,0,3,0,3,0.0,1.0,0.0
A05436,7,9,0,16,0.44,0.56,0.0
A05437,2,12,0,14,0.14,0.86,0.0
A05438,3,4,0,7,0.43,0.57,0.0
A05439,0,1,0,1,0.0,1.0,0.0
A05440,0,1,0,1,0.0,1.0,0.0
A05441,0,3,0,3,0.0,1.0,0.0
A05443,1,2,0,3,0.33,0.67,0.0
A05444,0,9,0,9,0.0,1.0,0.0
A05446,3,3,0,6,0.5,0.5,0.0
A05447,1,0,0,1,1.0,0.0,0.0
A05450,6,15,0,21,0.29,0.71,0.0
A05451,8,7,0,15,0.53,0.47,0.0
A05452,1,0,0,1,1.0,0.0,0.0
A05455,1,11,0,12,0.08,0.92,0.0
A05456,1,9,0,10,0.1,0.9,0.0
A05457,0,8,0,8,0.0,1.0,0.0
A05458,3,11,0,14,0.21,0.79,0.0
A05459,1,6,0,7,0.14,0.86,0.0
A05460,15,12,0,27,0.56,0.44,0.0
A05461,5,2,0,7,0.71,0.29,0.0
A05462,0,8,0,8,0.0,1.0,0.0
A05463,0,2,0,2,0.0,1.0,0.0
A05464,8,10,0,18,0.44,0.56,0.0
A05465,1,5,0,6,0.17,0.83,0.0
A05467,1,2,0,3,0.33,0.67,0.0
A05468,3,4,0,7,0.43,0.57,0.0
A05471,2,5,0,7,0.29,0.71,0.0
A05473,1,7,0,8,0.12,0.88,0.0
A05474,0,2,0,2,0.0,1.0,0.0
A05475,3,6,0,9,0.33,0.67,0.0
A05476,2,3,0,5,0.4,0.6,0.0
A05477,0,1,0,1,0.0,1.0,0.0
A05479,6,2,0,8,0.75,0.25,0.0
A05480,1,4,0,5,0.2,0.8,0.0
A05481,1,1,0,2,0.5,0.5,0.0
A05482,1,2,0,3,0.33,0.67,0.0
A05483,0,3,0,3,0.0,1.0,0.0
A05485,0,4,0,4,0.0,1.0,0.0
A05486,1,3,0,4,0.25,0.75,0.0
A05487,18,16,1,35,0.51,0.46,0.03
A05488,7,1,0,8,0.88,0.12,0.0
A05490,0,2,0,2,0.0,1.0,0.0
A05491,0,1,0,1,0.0,1.0,0.0
A05493,1,12,0,13,0.08,0.92,0.0
A05494,3,10,0,13,0.23,0.77,0.0
A05495,4,2,0,6,0.67,0.33,0.0
A05496,1,3,0,4,0.25,0.75,0.0
A05497,1,2,0,3,0.33,0.67,0.0
A05498,0,2,0,2,0.0,1.0,0.0
A05500,3,6,0,9,0.33,0.67,0.0
A05501,4,6,0,10,0.4,0.6,0.0
A05502,0,2,0,2,0.0,1.0,0.0
A05503,197,152,0,349,0.56,0.44,0.0
A05504,8,3,0,11,0.73,0.27,0.0
A05505,24,20,0,44,0.55,0.45,0.0
A05506,1,1,0,2,0.5,0.5,0.0
A05507,1,3,0,4,0.25,0.75,0.0
A05508,1,3,0,4,0.25,0.75,0.0
A05509,0,1,0,1,0.0,1.0,0.0
A05513,0,1,0,1,0.0,1.0,0.0
A05514,1,3,0,4,0.25,0.75,0.0
A05516,8,19,0,27,0.3,0.7,0.0
A05517,5,15,0,20,0.25,0.75,0.0
A05518,9,7,0,16,0.56,0.44,0.0
A05519,10,17,0,27,0.37,0.63,0.0
A05520,2,3,0,5,0.4,0.6,0.0
A05521,1,1,0,2,0.5,0.5,0.0
A05523,0,6,0,6,0.0,1.0,0.0
A05525,1,1,0,2,0.5,0.5,0.0
A05526,2,7,0,9,0.22,0.78,0.0
A05527,13,5,0,18,0.72,0.28,0.0
A05528,5,11,0,16,0.31,0.69,0.0
A05532,0,6,0,6,0.0,1.0,0.0
A05533,0,1,0,1,0.0,1.0,0.0
A05534,0,1,0,1,0.0,1.0,0.0
A05536,5,7,0,12,0.42,0.58,0.0
A05537,7,7,0,14,0.5,0.5,0.0
A05538,8,14,0,22,0.36,0.64,0.0
A05539,0,5,0,5,0.0,1.0,0.0
A05540,0,2,0,2,0.0,1.0,0.0
A05541,1,1,0,2,0.5,0.5,0.0
A05542,0,4,0,4,0.0,1.0,0.0
A05543,1,8,0,9,0.11,0.89,0.0
A05544,3,1,0,4,0.75,0.25,0.0
A05545,4,10,0,14,0.29,0.71,0.0
A05546,2,1,0,3,0.67,0.33,0.0
A05547,3,13,0,16,0.19,0.81,0.0
A05549,1,6,0,7,0.14,0.86,0.0
A05550,1,3,0,4,0.25,0.75,0.0
A05551,0,1,0,1,0.0,1.0,0.0
A05552,1,5,0,6,0.17,0.83,0.0
A05553,1,9,0,10,0.1,0.9,0.0
A05554,4,9,0,13,0.31,0.69,0.0
A05555,1,9,0,10,0.1,0.9,0.0
A05556,2,7,0,9,0.22,0.78,0.0
A05557,12,11,0,23,0.52,0.48,0.0
A05558,12,24,0,36,0.33,0.67,0.0
A05559,2,6,0,8,0.25,0.75,0.0
A05561,3,3,0,6,0.5,0.5,0.0
A05563,1,5,0,6,0.17,0.83,0.0
A05565,10,15,0,25,0.4,0.6,0.0
A05566,0,1,0,1,0.0,1.0,0.0
A05567,0,3,0,3,0.0,1.0,0.0
A05568,0,1,0,1,0.0,1.0,0.0
A05569,3,1,0,4,0.75,0.25,0.0
A05570,0,1,0,1,0.0,1.0,0.0
A05571,1,7,0,8,0.12,0.88,0.0
A05572,0,3,0,3,0.0,1.0,0.0
A05573,0,2,0,2,0.0,1.0,0.0
A05574,0,4,0,4,0.0,1.0,0.0
A05575,1,4,0,5,0.2,0.8,0.0
A05576,0,2,0,2,0.0,1.0,0.0
A05578,0,2,0,2,0.0,1.0,0.0
A05579,2,13,0,15,0.13,0.87,0.0
A05580,0,4,0,4,0.0,1.0,0.0
A05581,0,8,1,9,0.0,0.89,0.11
A05582,0,1,0,1,0.0,1.0,0.0
A05583,2,2,1,5,0.4,0.4,0.2
A05584,1,4,0,5,0.2,0.8,0.0
A05585,0,3,0,3,0.0,1.0,0.0
A05586,0,2,0,2,0.0,1.0,0.0
A05587,0,2,0,2,0.0,1.0,0.0
A05588,2,9,0,11,0.18,0.82,0.0
A05589,4,3,0,7,0.57,0.43,0.0
A05591,1,1,0,2,0.5,0.5,0.0
A05593,1,7,0,8,0.12,0.88,0.0
A05595,5,6,0,11,0.45,0.55,0.0
A05596,1,2,0,3,0.33,0.67,0.0
A05597,6,9,0,15,0.4,0.6,0.0
A05598,6,20,0,26,0.23,0.77,0.0
A05602,0,3,0,3,0.0,1.0,0.0
A05603,0,1,0,1,0.0,1.0,0.0
A05605,0,7,0,7,0.0,1.0,0.0
A05606,16,16,1,33,0.48,0.48,0.03
A05607,1,2,0,3,0.33,0.67,0.0
A05609,0,4,0,4,0.0,1.0,0.0
A05610,4,7,0,11,0.36,0.64,0.0
A05611,2,4,0,6,0.33,0.67,0.0
A05612,4,10,0,14,0.29,0.71,0.0
A05613,0,7,0,7,0.0,1.0,0.0
A05615,0,2,0,2,0.0,1.0,0.0
A05616,12,6,0,18,0.67,0.33,0.0
A05617,3,7,0,10,0.3,0.7,0.0
A05618,0,2,0,2,0.0,1.0,0.0
A05619,13,29,0,42,0.31,0.69,0.0
A05620,0,1,0,1,0.0,1.0,0.0
A05621,4,7,0,11,0.36,0.64,0.0
A05623,0,4,0,4,0.0,1.0,0.0
A05624,1,4,0,5,0.2,0.8,0.0
A05625,0,3,0,3,0.0,1.0,0.0
A05626,19,6,0,25,0.76,0.24,0.0
A05628,2,1,0,3,0.67,0.33,0.0
A05629,3,2,0,5,0.6,0.4,0.0
A05630,0,4,0,4,0.0,1.0,0.0
A05631,2,5,0,7,0.29,0.71,0.0
A05632,2,7,1,10,0.2,0.7,0.1
A05633,4,11,0,15,0.27,0.73,0.0
A05635,2,6,0,8,0.25,0.75,0.0
A05636,1,3,0,4,0.25,0.75,0.0
A05637,2,3,0,5,0.4,0.6,0.0
A05638,1,2,0,3,0.33,0.67,0.0
A05639,0,1,0,1,0.0,1.0,0.0
A05642,0,4,0,4,0.0,1.0,0.0
A05644,0,6,0,6,0.0,1.0,0.0
A05646,4,3,0,7,0.57,0.43,0.0
A05647,2,3,0,5,0.4,0.6,0.0
A05648,3,2,0,5,0.6,0.4,0.0
A05649,2,6,0,8,0.25,0.75,0.0
A05651,0,4,0,4,0.0,1.0,0.0
A05652,22,9,0,31,0.71,0.29,0.0
A05653,2,5,0,7,0.29,0.71,0.0
A05654,2,7,0,9,0.22,0.78,0.0
A05655,3,0,0,3,1.0,0.0,0.0
A05656,8,17,0,25,0.32,0.68,0.0
A05657,1,0,0,1,1.0,0.0,0.0
A05658,0,6,0,6,0.0,1.0,0.0
A05659,2,6,0,8,0.25,0.75,0.0
A05660,1,2,0,3,0.33,0.67,0.0
A05661,11,8,0,19,0.58,0.42,0.0
A05663,1,7,0,8,0.12,0.88,0.0
A05664,4,18,1,23,0.17,0.78,0.04
A05665,0,1,0,1,0.0,1.0,0.0
A05667,7,11,0,18,0.39,0.61,0.0
A05668,0,1,0,1,0.0,1.0,0.0
A05669,0,3,0,3,0.0,1.0,0.0
A05670,2,4,0,6,0.33,0.67,0.0
A05671,0,3,0,3,0.0,1.0,0.0
A05672,0,4,0,4,0.0,1.0,0.0
A05673,7,12,0,19,0.37,0.63,0.0
A05674,0,1,0,1,0.0,1.0,0.0
A05675,12,9,0,21,0.57,0.43,0.0
A05676,2,0,0,2,1.0,0.0,0.0
A05677,2,0,0,2,1.0,0.0,0.0
A05681,5,18,0,23,0.22,0.78,0.0
A05683,2,1,0,3,0.67,0.33,0.0
A05685,2,8,0,10,0.2,0.8,0.0
A05686,1,7,0,8,0.12,0.88,0.0
A05687,1,2,0,3,0.33,0.67,0.0
A05688,2,4,0,6,0.33,0.67,0.0
A05689,5,3,0,8,0.62,0.38,0.0
A05690,0,2,0,2,0.0,1.0,0.0
A05691,0,8,0,8,0.0,1.0,0.0
A05692,0,3,0,3,0.0,1.0,0.0
A05693,1,5,0,6,0.17,0.83,0.0
A05695,1,1,0,2,0.5,0.5,0.0
A05696,4,2,0,6,0.67,0.33,0.0
A05698,0,7,0,7,0.0,1.0,0.0
A05699,3,4,0,7,0.43,0.57,0.0
A05700,3,1,0,4,0.75,0.25,0.0
A05701,4,1,0,5,0.8,0.2,0.0
A05702,8,19,0,27,0.3,0.7,0.0
A05703,1,4,0,5,0.2,0.8,0.0
A05704,0,1,0,1,0.0,1.0,0.0
A05705,0,1,0,1,0.0,1.0,0.0
A05706,4,9,0,13,0.31,0.69,0.0
A05707,7,7,0,14,0.5,0.5,0.0
A05708,1,0,0,1,1.0,0.0,0.0
A05710,3,2,0,5,0.6,0.4,0.0
A05712,3,1,0,4,0.75,0.25,0.0
A05713,1,9,0,10,0.1,0.9,0.0
A05714,0,4,0,4,0.0,1.0,0.0
A05715,1,9,0,10,0.1,0.9,0.0
A05716,0,11,0,11,0.0,1.0,0.0
A05717,1,4,0,5,0.2,0.8,0.0
A05719,3,51,0,54,0.06,0.94,0.0
A05720,0,2,0,2,0.0,1.0,0.0
A05722,1,0,0,1,1.0,0.0,0.0
A05723,1,1,0,2,0.5,0.5,0.0
A05725,1,2,0,3,0.33,0.67,0.0
A05727,0,2,0,2,0.0,1.0,0.0
A05728,0,2,0,2,0.0,1.0,0.0
A05730,0,1,0,1,0.0,1.0,0.0
A05735,6,25,0,31,0.19,0.81,0.0
A05736,3,19,0,22,0.14,0.86,0.0
A05738,1,6,0,7,0.14,0.86,0.0
A05739,2,2,0,4,0.5,0.5,0.0
A05740,0,6,0,6,0.0,1.0,0.0
A05741,0,1,0,1,0.0,1.0,0.0
A05742,0,15,0,15,0.0,1.0,0.0
A05743,2,5,0,7,0.29,0.71,0.0
A05745,2,3,0,5,0.4,0.6,0.0
A05746,4,11,0,15,0.27,0.73,0.0
A05748,3,3,0,6,0.5,0.5,0.0
A05749,1,1,0,2,0.5,0.5,0.0
A05752,2,3,0,5,0.4,0.6,0.0
A05753,0,3,0,3,0.0,1.0,0.0
A05756,0,1,0,1,0.0,1.0,0.0
A05757,1,8,0,9,0.11,0.89,0.0
A05759,1,4,0,5,0.2,0.8,0.0
A05760,7,12,0,19,0.37,0.63,0.0
A05761,3,6,0,9,0.33,0.67,0.0
A05763,0,1,0,1,0.0,1.0,0.0
A05764,1,4,0,5,0.2,0.8,0.0
A05765,0,4,0,4,0.0,1.0,0.0
A05766,0,6,0,6,0.0,1.0,0.0
A05767,0,4,0,4,0.0,1.0,0.0
A05768,4,10,0,14,0.29,0.71,0.0
A05769,3,2,0,5,0.6,0.4,0.0
A05770,5,5,0,10,0.5,0.5,0.0
A05772,0,7,0,7,0.0,1.0,0.0
A05773,0,2,0,2,0.0,1.0,0.0
A05777,1,3,0,4,0.25,0.75,0.0
A05780,0,3,0,3,0.0,1.0,0.0
A05782,5,1,0,6,0.83,0.17,0.0
A05783,0,9,0,9,0.0,1.0,0.0
A05784,0,1,0,1,0.0,1.0,0.0
A05785,0,2,0,2,0.0,1.0,0.0
A05787,5,16,0,21,0.24,0.76,0.0
A05788,0,2,0,2,0.0,1.0,0.0
A05791,5,2,0,7,0.71,0.29,0.0
A05792,0,1,0,1,0.0,1.0,0.0
A05793,2,5,0,7,0.29,0.71,0.0
A05794,0,6,0,6,0.0,1.0,0.0
A05796,0,2,0,2,0.0,1.0,0.0
A05797,1,2,0,3,0.33,0.67,0.0
A05798,3,1,0,4,0.75,0.25,0.0
A05799,1,7,0,8,0.12,0.88,0.0
A05800,2,4,0,6,0.33,0.67,0.0
A05801,1,2,0,3,0.33,0.67,0.0
A05803,1,3,0,4,0.25,0.75,0.0
A05804,1,8,0,9,0.11,0.89,0.0
A05806,0,1,0,1,0.0,1.0,0.0
A05808,1,3,0,4,0.25,0.75,0.0
A05811,9,8,0,17,0.53,0.47,0.0
A05812,0,4,0,4,0.0,1.0,0.0
A05813,0,2,0,2,0.0,1.0,0.0
A05814,7,13,0,20,0.35,0.65,0.0
A05815,3,3,0,6,0.5,0.5,0.0
A05816,0,2,0,2,0.0,1.0,0.0
A05817,17,13,0,30,0.57,0.43,0.0
A05818,1,3,0,4,0.25,0.75,0.0
A05819,2,3,0,5,0.4,0.6,0.0
A05820,10,116,0,126,0.08,0.92,0.0
A05821,1,8,0,9,0.11,0.89,0.0
A05822,0,2,0,2,0.0,1.0,0.0
A05823,3,2,0,5,0.6,0.4,0.0
A05824,2,0,0,2,1.0,0.0,0.0
A05825,0,2,0,2,0.0,1.0,0.0
A05826,1,2,0,3,0.33,0.67,0.0
A05827,2,4,0,6,0.33,0.67,0.0
A05828,2,6,0,8,0.25,0.75,0.0
A05829,3,1,0,4,0.75,0.25,0.0
A05830,2,6,0,8,0.25,0.75,0.0
A05831,7,11,0,18,0.39,0.61,0.0
A05833,0,10,0,10,0.0,1.0,0.0
A05834,9,14,0,23,0.39,0.61,0.0
A05836,3,6,0,9,0.33,0.67,0.0
A05837,0,2,0,2,0.0,1.0,0.0
A05838,0,2,0,2,0.0,1.0,0.0
A05839,1,10,0,11,0.09,0.91,0.0
A05840,1,2,0,3,0.33,0.67,0.0
A05841,3,4,0,7,0.43,0.57,0.0
A05842,1,6,0,7,0.14,0.86,0.0
A05843,4,5,0,9,0.44,0.56,0.0
A05844,19,5,0,24,0.79,0.21,0.0
A05845,0,2,0,2,0.0,1.0,0.0
A05847,0,10,0,10,0.0,1.0,0.0
A05848,2,7,0,9,0.22,0.78,0.0
A05850,1,13,1,15,0.07,0.87,0.07
A05851,10,14,0,24,0.42,0.58,0.0
A05855,0,1,0,1,0.0,1.0,0.0
A05856,1,3,0,4,0.25,0.75,0.0
A05857,1,1,0,2,0.5,0.5,0.0
A05859,2,4,0,6,0.33,0.67,0.0
A05861,9,4,0,13,0.69,0.31,0.0
A05862,5,17,0,22,0.23,0.77,0.0
A05863,3,4,0,7,0.43,0.57,0.0
A05864,0,3,0,3,0.0,1.0,0.0
A05865,3,7,0,10,0.3,0.7,0.0
A05867,0,1,0,1,0.0,1.0,0.0
A05868,0,3,0,3,0.0,1.0,0.0
A05869,3,4,2,9,0.33,0.44,0.22
A05870,3,6,0,9,0.33,0.67,0.0
A05871,2,0,0,2,1.0,0.0,0.0
A05872,3,11,0,14,0.21,0.79,0.0
A05873,3,4,0,7,0.43,0.57,0.0
A05874,0,1,0,1,0.0,1.0,0.0
A05875,2,2,0,4,0.5,0.5,0.0
A05876,2,1,0,3,0.67,0.33,0.0
A05877,0,1,0,1,0.0,1.0,0.0
A05878,3,11,0,14,0.21,0.79,0.0
A05879,0,1,0,1,0.0,1.0,0.0
A05880,5,7,0,12,0.42,0.58,0.0
A05881,0,1,0,1,0.0,1.0,0.0
A05882,9,14,0,23,0.39,0.61,0.0
A05884,5,6,0,11,0.45,0.55,0.0
A05886,0,4,0,4,0.0,1.0,0.0
A05887,0,1,0,1,0.0,1.0,0.0
A05889,5,4,0,9,0.56,0.44,0.0
A05890,8,8,0,16,0.5,0.5,0.0
A05892,2,1,0,3,0.67,0.33,0.0
A05893,2,4,0,6,0.33,0.67,0.0
A05895,0,6,0,6,0.0,1.0,0.0
A05896,0,3,0,3,0.0,1.0,0.0
A05897,1,1,0,2,0.5,0.5,0.0
A05899,1,1,0,2,0.5,0.5,0.0
A05902,1,5,0,6,0.17,0.83,0.0
A05903,6,5,0,11,0.55,0.45,0.0
A05904,3,12,0,15,0.2,0.8,0.0
A05907,5,18,0,23,0.22,0.78,0.0
A05908,0,1,0,1,0.0,1.0,0.0
A05909,6,17,0,23,0.26,0.74,0.0
A05910,3,7,0,10,0.3,0.7,0.0
A05912,2,0,0,2,1.0,0.0,0.0
A05915,11,18,0,29,0.38,0.62,0.0
A05917,2,0,0,2,1.0,0.0,0.0
A05918,2,0,0,2,1.0,0.0,0.0
A05919,4,5,0,9,0.44,0.56,0.0
A05920,6,19,0,25,0.24,0.76,0.0
A05922,0,3,0,3,0.0,1.0,0.0
A05923,19,13,0,32,0.59,0.41,0.0
A05924,8,10,0,18,0.44,0.56,0.0
A05925,13,19,1,33,0.39,0.58,0.03
A05926,10,15,0,25,0.4,0.6,0.0
A05927,9,4,0,13,0.69,0.31,0.0
A05928,2,6,0,8,0.25,0.75,0.0
A05929,0,3,0,3,0.0,1.0,0.0
A05931,1,1,0,2,0.5,0.5,0.0
A05932,0,4,0,4,0.0,1.0,0.0
A05933,1,4,0,5,0.2,0.8,0.0
A05934,9,9,0,18,0.5,0.5,0.0
A05935,3,5,0,8,0.38,0.62,0.0
A05936,1,3,0,4,0.25,0.75,0.0
A05938,2,5,0,7,0.29,0.71,0.0
A05939,2,8,0,10,0.2,0.8,0.0
A05941,1,9,0,10,0.1,0.9,0.0
A05943,0,3,0,3,0.0,1.0,0.0
A05944,2,16,0,18,0.11,0.89,0.0
A05945,2,7,0,9,0.22,0.78,0.0
A05946,12,4,0,16,0.75,0.25,0.0
A05947,0,6,0,6,0.0,1.0,0.0
A05948,1,4,0,5,0.2,0.8,0.0
A05949,26,11,0,37,0.7,0.3,0.0
A05950,0,1,0,1,0.0,1.0,0.0
A05952,0,1,0,1,0.0,1.0,0.0
A05953,1,3,0,4,0.25,0.75,0.0
A05954,5,5,0,10,0.5,0.5,0.0
A05956,2,1,0,3,0.67,0.33,0.0
A05957,4,4,0,8,0.5,0.5,0.0
A05958,2,25,0,27,0.07,0.93,0.0
A05959,0,1,0,1,0.0,1.0,0.0
A05961,1,5,0,6,0.17,0.83,0.0
A05962,1,6,0,7,0.14,0.86,0.0
A05963,2,5,0,7,0.29,0.71,0.0
A05964,5,7,0,12,0.42,0.58,0.0
A05965,0,2,0,2,0.0,1.0,0.0
A05966,0,2,0,2,0.0,1.0,0.0
A05968,1,0,0,1,1.0,0.0,0.0
A05969,3,3,0,6,0.5,0.5,0.0
A05970,1,0,0,1,1.0,0.0,0.0
A05971,0,4,0,4,0.0,1.0,0.0
A05972,6,3,0,9,0.67,0.33,0.0
A05973,0,3,0,3,0.0,1.0,0.0
A05974,1,1,0,2,0.5,0.5,0.0
A05975,1,1,0,2,0.5,0.5,0.0
A05976,0,1,0,1,0.0,1.0,0.0
A05977,11,15,1,27,0.41,0.56,0.04
A05978,1,1,0,2,0.5,0.5,0.0
A05979,5,5,0,10,0.5,0.5,0.0
A05980,1,0,0,1,1.0,0.0,0.0
A05981,9,14,0,23,0.39,0.61,0.0
A05982,0,1,0,1,0.0,1.0,0.0
A05983,1,5,0,6,0.17,0.83,0.0
A05984,1,2,0,3,0.33,0.67,0.0
A05985,0,5,0,5,0.0,1.0,0.0
A05986,0,1,0,1,0.0,1.0,0.0
A05988,0,4,0,4,0.0,1.0,0.0
A05989,3,2,0,5,0.6,0.4,0.0
A05992,2,7,0,9,0.22,0.78,0.0
A05993,2,6,0,8,0.25,0.75,0.0
A05994,10,15,6,31,0.32,0.48,0.19
A05995,16,9,0,25,0.64,0.36,0.0
A05996,6,0,0,6,1.0,0.0,0.0
A05997,8,5,1,14,0.57,0.36,0.07
A05998,0,5,0,5,0.0,1.0,0.0
A06000,3,26,0,29,0.1,0.9,0.0
A06001,1,5,0,6,0.17,0.83,0.0
A06002,8,17,0,25,0.32,0.68,0.0
A06003,1,4,0,5,0.2,0.8,0.0
A06004,0,1,0,1,0.0,1.0,0.0
A06005,0,0,1,1,0.0,0.0,1.0
A06007,6,17,0,23,0.26,0.74,0.0
A06008,0,2,0,2,0.0,1.0,0.0
A06009,1,3,0,4,0.25,0.75,0.0
A06010,0,2,0,2,0.0,1.0,0.0
A06011,0,2,0,2,0.0,1.0,0.0
A06013,0,6,0,6,0.0,1.0,0.0
A06014,3,2,1,6,0.5,0.33,0.17
A06017,0,3,0,3,0.0,1.0,0.0
A06018,4,8,0,12,0.33,0.67,0.0
A06019,4,3,0,7,0.57,0.43,0.0
A06020,1,1,0,2,0.5,0.5,0.0
A06021,1,10,0,11,0.09,0.91,0.0
A06022,1,4,0,5,0.2,0.8,0.0
A06023,1,4,0,5,0.2,0.8,0.0
A06024,11,5,0,16,0.69,0.31,0.0
A06025,4,0,0,4,1.0,0.0,0.0
A06026,0,3,0,3,0.0,1.0,0.0
A06027,1,4,0,5,0.2,0.8,0.0
A06028,0,1,0,1,0.0,1.0,0.0
A06029,2,5,0,7,0.29,0.71,0.0
A06030,0,2,0,2,0.0,1.0,0.0
A06033,4,4,0,8,0.5,0.5,0.0
A06034,2,0,0,2,1.0,0.0,0.0
A06035,2,2,0,4,0.5,0.5,0.0
A06036,2,14,0,16,0.12,0.88,0.0
A06038,1,1,0,2,0.5,0.5,0.0
A06039,0,2,0,2,0.0,1.0,0.0
A06040,1,8,0,9,0.11,0.89,0.0
A06041,2,7,0,9,0.22,0.78,0.0
A06042,3,5,0,8,0.38,0.62,0.0
A06043,3,7,0,10,0.3,0.7,0.0
A06044,1,1,0,2,0.5,0.5,0.0
A06045,1,1,0,2,0.5,0.5,0.0
A06046,0,1,0,1,0.0,1.0,0.0
A06050,0,1,0,1,0.0,1.0,0.0
A06051,4,7,0,11,0.36,0.64,0.0
A06052,0,3,0,3,0.0,1.0,0.0
A06054,0,1,0,1,0.0,1.0,0.0
A06055,0,1,0,1,0.0,1.0,0.0
A06057,2,1,0,3,0.67,0.33,0.0
A06058,3,9,0,12,0.25,0.75,0.0
A06059,0,2,0,2,0.0,1.0,0.0
A06064,5,15,0,20,0.25,0.75,0.0
A06065,11,28,0,39,0.28,0.72,0.0
A06066,4,7,0,11,0.36,0.64,0.0
A06067,33,29,0,62,0.53,0.47,0.0
A06068,2,1,0,3,0.67,0.33,0.0
A06069,2,3,0,5,0.4,0.6,0.0
A06074,5,5,0,10,0.5,0.5,0.0
A06075,0,1,0,1,0.0,1.0,0.0
A06077,2,5,0,7,0.29,0.71,0.0
A06078,1,1,0,2,0.5,0.5,0.0
A06081,0,2,0,2,0.0,1.0,0.0
A06083,1,9,0,10,0.1,0.9,0.0
A06085,1,9,0,10,0.1,0.9,0.0
A06086,1,6,0,7,0.14,0.86,0.0
A06087,3,2,0,5,0.6,0.4,0.0
A06090,2,5,0,7,0.29,0.71,0.0
A06091,0,2,0,2,0.0,1.0,0.0
A06092,1,1,0,2,0.5,0.5,0.0
A06093,0,3,0,3,0.0,1.0,0.0
A06094,1,14,0,15,0.07,0.93,0.0
A06095,0,2,0,2,0.0,1.0,0.0
A06096,0,3,0,3,0.0,1.0,0.0
A06099,1,0,0,1,1.0,0.0,0.0
A06100,3,7,0,10,0.3,0.7,0.0
A06101,0,1,0,1,0.0,1.0,0.0
A06102,0,4,0,4,0.0,1.0,0.0
A06104,0,14,0,14,0.0,1.0,0.0
A06105,0,6,0,6,0.0,1.0,0.0
A06106,0,2,0,2,0.0,1.0,0.0
A06107,1,3,0,4,0.25,0.75,0.0
A06108,2,2,0,4,0.5,0.5,0.0
A06109,3,6,0,9,0.33,0.67,0.0
A06112,2,2,0,4,0.5,0.5,0.0
A06113,3,5,0,8,0.38,0.62,0.0
A06114,1,9,0,10,0.1,0.9,0.0
A06115,3,15,0,18,0.17,0.83,0.0
A06116,0,11,0,11,0.0,1.0,0.0
A06118,0,1,0,1,0.0,1.0,0.0
A06119,0,11,0,11,0.0,1.0,0.0
A06120,6,17,0,23,0.26,0.74,0.0
A06122,3,2,0,5,0.6,0.4,0.0
A06123,2,6,0,8,0.25,0.75,0.0
A06124,0,1,0,1,0.0,1.0,0.0
A06126,0,1,0,1,0.0,1.0,0.0
A06127,2,10,0,12,0.17,0.83,0.0
A06128,1,20,0,21,0.05,0.95,0.0
A06130,2,0,0,2,1.0,0.0,0.0
A06131,2,0,0,2,1.0,0.0,0.0
A06132,2,5,0,7,0.29,0.71,0.0
A06133,1,2,0,3,0.33,0.67,0.0
A06134,0,7,0,7,0.0,1.0,0.0
A06135,2,3,0,5,0.4,0.6,0.0
A06137,0,2,0,2,0.0,1.0,0.0
A06139,1,10,0,11,0.09,0.91,0.0
A06140,1,2,0,3,0.33,0.67,0.0
A06141,3,7,0,10,0.3,0.7,0.0
A06146,2,2,0,4,0.5,0.5,0.0
A06148,3,8,0,11,0.27,0.73,0.0
A06150,4,11,0,15,0.27,0.73,0.0
A06151,0,3,0,3,0.0,1.0,0.0
A06152,6,4,0,10,0.6,0.4,0.0
A06153,0,9,0,9,0.0,1.0,0.0
A06154,1,3,0,4,0.25,0.75,0.0
A06155,2,7,0,9,0.22,0.78,0.0
A06156,0,2,0,2,0.0,1.0,0.0
A06157,2,1,0,3,0.67,0.33,0.0
A06158,4,4,0,8,0.5,0.5,0.0
A06159,1,2,0,3,0.33,0.67,0.0
A06160,0,4,0,4,0.0,1.0,0.0
A06161,6,8,0,14,0.43,0.57,0.0
A06162,1,6,0,7,0.14,0.86,0.0
A06163,4,8,0,12,0.33,0.67,0.0
A06164,3,16,0,19,0.16,0.84,0.0
A06165,2,4,0,6,0.33,0.67,0.0
A06166,1,0,0,1,1.0,0.0,0.0
A06167,1,4,0,5,0.2,0.8,0.0
A06168,2,21,0,23,0.09,0.91,0.0
A06169,0,4,0,4,0.0,1.0,0.0
A06170,2,1,0,3,0.67,0.33,0.0
A06172,6,11,0,17,0.35,0.65,0.0
A06173,0,2,0,2,0.0,1.0,0.0
A06174,0,3,0,3,0.0,1.0,0.0
A06175,1,7,0,8,0.12,0.88,0.0
A06176,0,4,0,4,0.0,1.0,0.0
A06177,2,14,0,16,0.12,0.88,0.0
A06179,0,2,0,2,0.0,1.0,0.0
A06180,0,3,0,3,0.0,1.0,0.0
A06181,2,3,0,5,0.4,0.6,0.0
A06182,0,4,0,4,0.0,1.0,0.0
A06183,1,0,0,1,1.0,0.0,0.0
A06184,0,1,0,1,0.0,1.0,0.0
A06185,1,7,0,8,0.12,0.88,0.0
A06187,0,1,0,1,0.0,1.0,0.0
A06188,2,3,0,5,0.4,0.6,0.0
A06189,1,6,0,7,0.14,0.86,0.0
A06190,4,2,0,6,0.67,0.33,0.0
A06192,1,0,0,1,1.0,0.0,0.0
A06193,3,3,0,6,0.5,0.5,0.0
A06194,0,5,0,5,0.0,1.0,0.0
A06195,0,4,0,4,0.0,1.0,0.0
A06196,0,5,0,5,0.0,1.0,0.0
A06197,0,5,0,5,0.0,1.0,0.0
A06198,2,2,0,4,0.5,0.5,0.0
A06199,0,6,0,6,0.0,1.0,0.0
A06200,7,18,0,25,0.28,0.72,0.0
A06201,0,3,0,3,0.0,1.0,0.0
A06202,7,6,0,13,0.54,0.46,0.0
A06203,0,2,0,2,0.0,1.0,0.0
A06204,0,3,0,3,0.0,1.0,0.0
A06205,5,6,0,11,0.45,0.55,0.0
A06206,0,4,0,4,0.0,1.0,0.0
A06207,0,6,0,6,0.0,1.0,0.0
A06208,0,3,0,3,0.0,1.0,0.0
A06209,0,10,0,10,0.0,1.0,0.0
A06210,2,0,0,2,1.0,0.0,0.0
A06212,1,8,0,9,0.11,0.89,0.0
A06213,1,1,0,2,0.5,0.5,0.0
A06214,2,6,0,8,0.25,0.75,0.0
A06215,6,6,1,13,0.46,0.46,0.08
A06216,0,2,0,2,0.0,1.0,0.0
A06217,0,3,0,3,0.0,1.0,0.0
A06218,1,3,0,4,0.25,0.75,0.0
A06219,0,2,0,2,0.0,1.0,0.0
A06220,11,12,0,23,0.48,0.52,0.0
A06221,9,24,0,33,0.27,0.73,0.0
A06222,0,2,0,2,0.0,1.0,0.0
A06223,0,2,0,2,0.0,1.0,0.0
A06224,2,13,0,15,0.13,0.87,0.0
A06225,1,4,0,5,0.2,0.8,0.0
A06226,0,6,0,6,0.0,1.0,0.0
A06228,2,9,0,11,0.18,0.82,0.0
A06229,4,12,0,16,0.25,0.75,0.0
A06230,3,8,0,11,0.27,0.73,0.0
A06231,10,24,0,34,0.29,0.71,0.0
A06232,0,6,0,6,0.0,1.0,0.0
A06233,0,1,0,1,0.0,1.0,0.0
A06234,0,2,0,2,0.0,1.0,0.0
A06235,1,5,0,6,0.17,0.83,0.0
A06236,19,24,0,43,0.44,0.56,0.0
A06237,0,16,0,16,0.0,1.0,0.0
A06238,6,19,0,25,0.24,0.76,0.0
A06239,3,4,0,7,0.43,0.57,0.0
A06240,0,4,0,4,0.0,1.0,0.0
A06241,5,1,0,6,0.83,0.17,0.0
A06242,0,4,0,4,0.0,1.0,0.0
A06243,0,1,0,1,0.0,1.0,0.0
A06245,0,3,0,3,0.0,1.0,0.0
A06246,12,24,0,36,0.33,0.67,0.0
A06247,2,5,0,7,0.29,0.71,0.0
A06248,0,2,0,2,0.0,1.0,0.0
A06249,0,6,0,6,0.0,1.0,0.0
A06251,0,1,0,1,0.0,1.0,0.0
A06252,0,1,0,1,0.0,1.0,0.0
A06253,4,22,0,26,0.15,0.85,0.0
A06254,0,6,0,6,0.0,1.0,0.0
A06255,0,2,0,2,0.0,1.0,0.0
A06256,0,1,0,1,0.0,1.0,0.0
A06259,37,6,0,43,0.86,0.14,0.0
A06260,6,10,0,16,0.38,0.62,0.0
A06261,0,14,0,14,0.0,1.0,0.0
A06262,14,19,0,33,0.42,0.58,0.0
A06264,10,0,0,10,1.0,0.0,0.0
A06265,2,8,0,10,0.2,0.8,0.0
A06266,2,6,0,8,0.25,0.75,0.0
A06267,20,2,0,22,0.91,0.09,0.0
A06268,2,2,0,4,0.5,0.5,0.0
A06269,2,4,0,6,0.33,0.67,0.0
A06270,8,4,0,12,0.67,0.33,0.0
A06271,0,5,0,5,0.0,1.0,0.0
A06272,3,3,0,6,0.5,0.5,0.0
A06273,0,5,0,5,0.0,1.0,0.0
A06274,0,1,0,1,0.0,1.0,0.0
A06275,0,5,0,5,0.0,1.0,0.0
A06277,4,5,0,9,0.44,0.56,0.0
A06278,1,1,0,2,0.5,0.5,0.0
A06279,1,4,0,5,0.2,0.8,0.0
A06281,1,10,0,11,0.09,0.91,0.0
A06282,0,5,0,5,0.0,1.0,0.0
A06283,0,3,0,3,0.0,1.0,0.0
A06284,0,9,0,9,0.0,1.0,0.0
A06285,2,4,0,6,0.33,0.67,0.0
A06286,1,2,0,3,0.33,0.67,0.0
A06287,7,7,0,14,0.5,0.5,0.0
A06288,0,5,0,5,0.0,1.0,0.0
A06289,0,2,0,2,0.0,1.0,0.0
A06290,1,14,0,15,0.07,0.93,0.0
A06291,1,5,0,6,0.17,0.83,0.0
A06292,2,4,0,6,0.33,0.67,0.0
A06294,5,10,0,15,0.33,0.67,0.0
A06295,1,4,0,5,0.2,0.8,0.0
A06296,1,11,0,12,0.08,0.92,0.0
A06297,0,1,0,1,0.0,1.0,0.0
A06299,5,6,0,11,0.45,0.55,0.0
A06300,1,0,0,1,1.0,0.0,0.0
A06301,0,6,0,6,0.0,1.0,0.0
A06303,1,5,0,6,0.17,0.83,0.0
A06304,7,38,0,45,0.16,0.84,0.0
A06306,2,6,0,8,0.25,0.75,0.0
A06307,0,5,0,5,0.0,1.0,0.0
A06308,1,4,0,5,0.2,0.8,0.0
A06309,10,23,0,33,0.3,0.7,0.0
A06311,0,1,0,1,0.0,1.0,0.0
A06312,0,1,0,1,0.0,1.0,0.0
A06314,9,20,0,29,0.31,0.69,0.0
A06315,0,1,0,1,0.0,1.0,0.0
A06316,0,1,0,1,0.0,1.0,0.0
A06317,3,15,0,18,0.17,0.83,0.0
A06318,2,6,0,8,0.25,0.75,0.0
A06319,0,3,0,3,0.0,1.0,0.0
A06321,0,3,0,3,0.0,1.0,0.0
A06323,5,28,0,33,0.15,0.85,0.0
A06324,1,5,0,6,0.17,0.83,0.0
A06325,6,6,0,12,0.5,0.5,0.0
A06327,2,0,0,2,1.0,0.0,0.0
A06328,1,12,0,13,0.08,0.92,0.0
A06331,2,11,0,13,0.15,0.85,0.0
A06332,5,15,0,20,0.25,0.75,0.0
A06336,0,7,0,7,0.0,1.0,0.0
A06337,0,1,0,1,0.0,1.0,0.0
A06339,2,8,0,10,0.2,0.8,0.0
A06341,1,2,0,3,0.33,0.67,0.0
A06342,1,10,0,11,0.09,0.91,0.0
A06343,0,2,0,2,0.0,1.0,0.0
A06346,0,4,0,4,0.0,1.0,0.0
A06347,0,3,0,3,0.0,1.0,0.0
A06348,2,3,0,5,0.4,0.6,0.0
A06349,0,1,0,1,0.0,1.0,0.0
A06350,4,7,0,11,0.36,0.64,0.0
A06351,0,2,0,2,0.0,1.0,0.0
A06352,0,2,0,2,0.0,1.0,0.0
A06353,2,32,0,34,0.06,0.94,0.0
A06356,1,7,0,8,0.12,0.88,0.0
A06358,8,23,0,31,0.26,0.74,0.0
A06359,1,1,0,2,0.5,0.5,0.0
A06360,0,12,0,12,0.0,1.0,0.0
A06361,2,6,0,8,0.25,0.75,0.0
A06362,2,1,0,3,0.67,0.33,0.0
A06363,0,2,0,2,0.0,1.0,0.0
A06364,0,1,0,1,0.0,1.0,0.0
A06365,6,11,1,18,0.33,0.61,0.06
A06366,0,3,0,3,0.0,1.0,0.0
A06368,0,3,0,3,0.0,1.0,0.0
A06369,0,3,0,3,0.0,1.0,0.0
A06371,2,3,0,5,0.4,0.6,0.0
A06372,0,9,0,9,0.0,1.0,0.0
A06373,4,4,0,8,0.5,0.5,0.0
A06374,1,7,0,8,0.12,0.88,0.0
A06375,4,10,1,15,0.27,0.67,0.07
A06376,8,17,0,25,0.32,0.68,0.0
A06377,2,7,0,9,0.22,0.78,0.0
A06378,1,4,0,5,0.2,0.8,0.0
A06379,1,0,0,1,1.0,0.0,0.0
A06380,10,10,0,20,0.5,0.5,0.0
A06381,3,9,0,12,0.25,0.75,0.0
A06382,56,55,0,111,0.5,0.5,0.0
A06383,0,1,0,1,0.0,1.0,0.0
A06384,0,1,0,1,0.0,1.0,0.0
A06385,0,1,0,1,0.0,1.0,0.0
A06386,3,21,0,24,0.12,0.88,0.0
A06389,7,12,0,19,0.37,0.63,0.0
A06390,2,35,0,37,0.05,0.95,0.0
A06391,2,9,0,11,0.18,0.82,0.0
A06392,0,5,0,5,0.0,1.0,0.0
A06393,2,21,0,23,0.09,0.91,0.0
A06394,0,4,0,4,0.0,1.0,0.0
A06395,1,2,0,3,0.33,0.67,0.0
A06396,1,3,0,4,0.25,0.75,0.0
A06397,0,1,0,1,0.0,1.0,0.0
A06398,1,10,0,11,0.09,0.91,0.0
A06400,0,1,0,1,0.0,1.0,0.0
A06402,2,3,0,5,0.4,0.6,0.0
A06403,2,1,0,3,0.67,0.33,0.0
A06404,0,2,0,2,0.0,1.0,0.0
A06405,0,3,0,3,0.0,1.0,0.0
A06406,0,2,0,2,0.0,1.0,0.0
A06408,14,24,0,38,0.37,0.63,0.0
A06409,1,1,0,2,0.5,0.5,0.0
A06410,0,1,0,1,0.0,1.0,0.0
A06411,2,4,0,6,0.33,0.67,0.0
A06412,2,7,0,9,0.22,0.78,0.0
A06413,2,3,0,5,0.4,0.6,0.0
A06414,2,9,0,11,0.18,0.82,0.0
A06415,5,7,0,12,0.42,0.58,0.0
A06416,3,4,0,7,0.43,0.57,0.0
A06417,2,8,0,10,0.2,0.8,0.0
A06418,0,3,0,3,0.0,1.0,0.0
A06419,1,0,0,1,1.0,0.0,0.0
A06422,0,3,0,3,0.0,1.0,0.0
A06423,5,18,0,23,0.22,0.78,0.0
A06424,0,1,0,1,0.0,1.0,0.0
A06425,0,1,0,1,0.0,1.0,0.0
A06426,0,2,0,2,0.0,1.0,0.0
A06427,0,2,0,2,0.0,1.0,0.0
A06428,0,2,0,2,0.0,1.0,0.0
A06429,0,2,0,2,0.0,1.0,0.0
A06430,2,8,0,10,0.2,0.8,0.0
A06431,1,0,0,1,1.0,0.0,0.0
A06432,13,14,0,27,0.48,0.52,0.0
A06433,2,13,0,15,0.13,0.87,0.0
A06435,1,9,0,10,0.1,0.9,0.0
A06436,0,4,0,4,0.0,1.0,0.0
A06437,1,2,0,3,0.33,0.67,0.0
A06438,0,1,0,1,0.0,1.0,0.0
A06441,0,1,0,1,0.0,1.0,0.0
A06443,0,1,0,1,0.0,1.0,0.0
A06444,1,1,0,2,0.5,0.5,0.0
A06445,7,23,0,30,0.23,0.77,0.0
A06446,0,6,0,6,0.0,1.0,0.0
A06447,3,5,0,8,0.38,0.62,0.0
A06449,0,1,0,1,0.0,1.0,0.0
A06450,0,1,0,1,0.0,1.0,0.0
A06451,0,1,0,1,0.0,1.0,0.0
A06453,1,0,0,1,1.0,0.0,0.0
A06455,5,4,0,9,0.56,0.44,0.0
A06458,1,11,0,12,0.08,0.92,0.0
A06459,0,2,0,2,0.0,1.0,0.0
A06460,3,3,0,6,0.5,0.5,0.0
A06461,3,15,0,18,0.17,0.83,0.0
A06462,4,5,0,9,0.44,0.56,0.0
A06465,0,2,0,2,0.0,1.0,0.0
A06467,2,3,0,5,0.4,0.6,0.0
A06468,2,2,0,4,0.5,0.5,0.0
A06469,1,1,0,2,0.5,0.5,0.0
A06470,3,7,0,10,0.3,0.7,0.0
A06471,6,7,0,13,0.46,0.54,0.0
A06472,4,5,0,9,0.44,0.56,0.0
A06473,7,13,0,20,0.35,0.65,0.0
A06474,8,4,0,12,0.67,0.33,0.0
A06475,0,4,0,4,0.0,1.0,0.0
A06476,0,3,0,3,0.0,1.0,0.0
A06479,1,4,0,5,0.2,0.8,0.0
A06482,2,4,0,6,0.33,0.67,0.0
A06484,0,8,0,8,0.0,1.0,0.0
A06485,3,2,0,5,0.6,0.4,0.0
A06486,1,2,0,3,0.33,0.67,0.0
A06487,2,4,0,6,0.33,0.67,0.0
A06488,0,3,0,3,0.0,1.0,0.0
A06489,4,10,0,14,0.29,0.71,0.0
A06491,0,1,0,1,0.0,1.0,0.0
A06493,0,4,0,4,0.0,1.0,0.0
A06494,4,10,0,14,0.29,0.71,0.0
A06495,3,2,0,5,0.6,0.4,0.0
A06496,8,8,0,16,0.5,0.5,0.0
A06497,3,5,0,8,0.38,0.62,0.0
A06498,0,1,0,1,0.0,1.0,0.0
A06499,0,8,0,8,0.0,1.0,0.0
A06500,3,8,0,11,0.27,0.73,0.0
A06501,1,3,0,4,0.25,0.75,0.0
A06502,1,6,0,7,0.14,0.86,0.0
A06504,0,1,0,1,0.0,1.0,0.0
A06505,1,6,0,7,0.14,0.86,0.0
A06507,1,2,0,3,0.33,0.67,0.0
A06508,1,7,0,8,0.12,0.88,0.0
A06509,10,7,0,17,0.59,0.41,0.0
A06510,22,13,0,35,0.63,0.37,0.0
A06511,1,0,0,1,1.0,0.0,0.0
A06512,0,4,0,4,0.0,1.0,0.0
A06513,0,2,0,2,0.0,1.0,0.0
A06514,2,13,0,15,0.13,0.87,0.0
A06515,7,9,0,16,0.44,0.56,0.0
A06516,0,3,0,3,0.0,1.0,0.0
A06517,0,5,0,5,0.0,1.0,0.0
A06518,0,3,0,3,0.0,1.0,0.0
A06520,1,3,0,4,0.25,0.75,0.0
A06525,2,2,0,4,0.5,0.5,0.0
A06526,0,2,0,2,0.0,1.0,0.0
A06527,0,1,0,1,0.0,1.0,0.0
A06528,1,0,0,1,1.0,0.0,0.0
A06530,2,6,0,8,0.25,0.75,0.0
A06531,4,8,0,12,0.33,0.67,0.0
A06533,0,3,0,3,0.0,1.0,0.0
A06534,0,3,0,3,0.0,1.0,0.0
A06535,0,4,0,4,0.0,1.0,0.0
A06537,0,3,0,3,0.0,1.0,0.0
A06538,16,23,0,39,0.41,0.59,0.0
A06540,1,3,0,4,0.25,0.75,0.0
A06542,3,4,0,7,0.43,0.57,0.0
A06543,1,2,0,3,0.33,0.67,0.0
A06544,0,1,0,1,0.0,1.0,0.0
A06545,6,5,1,12,0.5,0.42,0.08
A06546,0,1,0,1,0.0,1.0,0.0
A06547,0,7,0,7,0.0,1.0,0.0
A06548,7,2,0,9,0.78,0.22,0.0
A06550,20,2,1,23,0.87,0.09,0.04
A06551,1,8,0,9,0.11,0.89,0.0
A06552,0,2,0,2,0.0,1.0,0.0
A06554,4,7,0,11,0.36,0.64,0.0
A06555,0,1,0,1,0.0,1.0,0.0
A06556,0,3,0,3,0.0,1.0,0.0
A06557,4,1,0,5,0.8,0.2,0.0
A06558,9,27,0,36,0.25,0.75,0.0
A06560,2,1,0,3,0.67,0.33,0.0
A06561,0,6,0,6,0.0,1.0,0.0
A06562,0,3,0,3,0.0,1.0,0.0
A06563,1,6,0,7,0.14,0.86,0.0
A06564,1,1,0,2,0.5,0.5,0.0
A06565,0,1,0,1,0.0,1.0,0.0
A06566,17,15,0,32,0.53,0.47,0.0
A06567,0,4,0,4,0.0,1.0,0.0
A06568,8,9,0,17,0.47,0.53,0.0
A06569,10,26,0,36,0.28,0.72,0.0
A06570,5,11,0,16,0.31,0.69,0.0
A06571,1,2,0,3,0.33,0.67,0.0
A06572,0,2,0,2,0.0,1.0,0.0
A06573,1,1,0,2,0.5,0.5,0.0
A06574,1,2,0,3,0.33,0.67,0.0
A06575,5,13,0,18,0.28,0.72,0.0
A06576,1,3,0,4,0.25,0.75,0.0
A06579,10,19,0,29,0.34,0.66,0.0
A06580,5,8,0,13,0.38,0.62,0.0
A06581,22,17,0,39,0.56,0.44,0.0
A06582,2,1,0,3,0.67,0.33,0.0
A06583,2,8,0,10,0.2,0.8,0.0
A06584,2,2,0,4,0.5,0.5,0.0
A06585,0,4,0,4,0.0,1.0,0.0
A06586,65,6,0,71,0.92,0.08,0.0
A06587,4,3,0,7,0.57,0.43,0.0
A06588,61,8,0,69,0.88,0.12,0.0
A06589,2,1,0,3,0.67,0.33,0.0
A06590,2,6,0,8,0.25,0.75,0.0
A06592,0,5,0,5,0.0,1.0,0.0
A06593,0,1,0,1,0.0,1.0,0.0
A06594,0,2,0,2,0.0,1.0,0.0
A06598,0,1,0,1,0.0,1.0,0.0
A06599,11,9,0,20,0.55,0.45,0.0
A06600,4,6,0,10,0.4,0.6,0.0
A06601,0,11,0,11,0.0,1.0,0.0
A06603,0,2,0,2,0.0,1.0,0.0
A06604,15,4,0,19,0.79,0.21,0.0
A06608,1,0,0,1,1.0,0.0,0.0
A06609,1,3,0,4,0.25,0.75,0.0
A06610,16,31,0,47,0.34,0.66,0.0
A06611,8,3,0,11,0.73,0.27,0.0
A06613,2,6,0,8,0.25,0.75,0.0
A06614,0,1,0,1,0.0,1.0,0.0
A06615,4,3,0,7,0.57,0.43,0.0
A06616,1,28,0,29,0.03,0.97,0.0
A06617,1,4,0,5,0.2,0.8,0.0
A06618,1,8,0,9,0.11,0.89,0.0
A06619,4,6,0,10,0.4,0.6,0.0
A06621,29,8,0,37,0.78,0.22,0.0
A06622,1,0,0,1,1.0,0.0,0.0
A06623,0,5,0,5,0.0,1.0,0.0
A06624,1,0,0,1,1.0,0.0,0.0
A06625,1,0,0,1,1.0,0.0,0.0
A06626,0,2,0,2,0.0,1.0,0.0
A06627,1,4,0,5,0.2,0.8,0.0
A06630,6,9,0,15,0.4,0.6,0.0
A06631,14,19,0,33,0.42,0.58,0.0
A06632,5,9,0,14,0.36,0.64,0.0
A06633,3,5,0,8,0.38,0.62,0.0
A06634,1,2,0,3,0.33,0.67,0.0
A06635,1,2,0,3,0.33,0.67,0.0
A06636,3,5,0,8,0.38,0.62,0.0
A06638,1,2,0,3,0.33,0.67,0.0
A06639,6,6,0,12,0.5,0.5,0.0
A06640,1,1,0,2,0.5,0.5,0.0
A06641,9,16,0,25,0.36,0.64,0.0
A06642,0,2,0,2,0.0,1.0,0.0
A06643,3,4,0,7,0.43,0.57,0.0
A06645,2,0,0,2,1.0,0.0,0.0
A06646,0,2,0,2,0.0,1.0,0.0
A06647,1,6,0,7,0.14,0.86,0.0
A06648,5,9,0,14,0.36,0.64,0.0
A06649,1,4,0,5,0.2,0.8,0.0
A06651,2,11,0,13,0.15,0.85,0.0
A06652,0,5,0,5,0.0,1.0,0.0
A06653,2,16,0,18,0.11,0.89,0.0
A06654,1,4,0,5,0.2,0.8,0.0
A06656,0,3,0,3,0.0,1.0,0.0
A06657,36,11,0,47,0.77,0.23,0.0
A06658,0,2,0,2,0.0,1.0,0.0
A06659,0,5,0,5,0.0,1.0,0.0
A06660,1,7,0,8,0.12,0.88,0.0
A06661,0,2,0,2,0.0,1.0,0.0
A06662,4,5,0,9,0.44,0.56,0.0
A06663,1,0,0,1,1.0,0.0,0.0
A06664,0,3,0,3,0.0,1.0,0.0
A06665,14,29,0,43,0.33,0.67,0.0
A06666,0,3,0,3,0.0,1.0,0.0
A06667,2,6,0,8,0.25,0.75,0.0
A06668,0,6,0,6,0.0,1.0,0.0
A06669,0,2,0,2,0.0,1.0,0.0
A06670,0,2,0,2,0.0,1.0,0.0
A06671,1,4,0,5,0.2,0.8,0.0
A06672,0,6,0,6,0.0,1.0,0.0
A06675,2,16,0,18,0.11,0.89,0.0
A06676,3,9,0,12,0.25,0.75,0.0
A06679,1,3,0,4,0.25,0.75,0.0
A06680,0,1,0,1,0.0,1.0,0.0
A06681,2,5,0,7,0.29,0.71,0.0
A06682,0,3,0,3,0.0,1.0,0.0
A06684,2,3,0,5,0.4,0.6,0.0
A06685,0,4,0,4,0.0,1.0,0.0
A06686,4,6,0,10,0.4,0.6,0.0
A06687,3,7,0,10,0.3,0.7,0.0
A06688,7,10,0,17,0.41,0.59,0.0
A06690,3,4,0,7,0.43,0.57,0.0
A06691,1,6,0,7,0.14,0.86,0.0
A06692,7,19,0,26,0.27,0.73,0.0
A06693,5,8,0,13,0.38,0.62,0.0
A06694,11,6,0,17,0.65,0.35,0.0
A06695,0,4,0,4,0.0,1.0,0.0
A06696,2,13,0,15,0.13,0.87,0.0
A06697,2,3,0,5,0.4,0.6,0.0
A06699,0,3,0,3,0.0,1.0,0.0
A06700,1,5,0,6,0.17,0.83,0.0
A06701,0,1,0,1,0.0,1.0,0.0
A06702,2,0,0,2,1.0,0.0,0.0
A06703,1,3,0,4,0.25,0.75,0.0
A06704,1,2,0,3,0.33,0.67,0.0
A06705,1,2,0,3,0.33,0.67,0.0
A06706,5,12,0,17,0.29,0.71,0.0
A06707,1,14,0,15,0.07,0.93,0.0
A06708,3,4,0,7,0.43,0.57,0.0
A06709,1,3,0,4,0.25,0.75,0.0
A06710,0,1,0,1,0.0,1.0,0.0
A06711,1,1,0,2,0.5,0.5,0.0
A06713,0,1,0,1,0.0,1.0,0.0
A06716,1,3,0,4,0.25,0.75,0.0
A06717,2,1,0,3,0.67,0.33,0.0
A06718,110,44,0,154,0.71,0.29,0.0
A06721,6,2,0,8,0.75,0.25,0.0
A06722,1,1,0,2,0.5,0.5,0.0
A06723,0,2,0,2,0.0,1.0,0.0
A06724,15,5,0,20,0.75,0.25,0.0
A06725,17,14,0,31,0.55,0.45,0.0
A06726,8,4,0,12,0.67,0.33,0.0
A06728,0,1,0,1,0.0,1.0,0.0
A06729,3,13,0,16,0.19,0.81,0.0
A06730,2,1,0,3,0.67,0.33,0.0
A06731,4,3,0,7,0.57,0.43,0.0
A06732,0,2,0,2,0.0,1.0,0.0
A06733,2,3,0,5,0.4,0.6,0.0
A06734,0,3,0,3,0.0,1.0,0.0
A06735,2,5,0,7,0.29,0.71,0.0
A06736,1,2,0,3,0.33,0.67,0.0
A06737,2,1,0,3,0.67,0.33,0.0
A06738,2,11,0,13,0.15,0.85,0.0
A06739,0,5,0,5,0.0,1.0,0.0
A06741,6,6,0,12,0.5,0.5,0.0
A06742,0,1,0,1,0.0,1.0,0.0
A06743,3,5,0,8,0.38,0.62,0.0
A06744,3,3,0,6,0.5,0.5,0.0
A06746,1,1,0,2,0.5,0.5,0.0
A06747,6,6,0,12,0.5,0.5,0.0
A06748,9,26,0,35,0.26,0.74,0.0
A06749,7,6,0,13,0.54,0.46,0.0
A06750,0,2,0,2,0.0,1.0,0.0
A06751,5,1,0,6,0.83,0.17,0.0
A06752,0,2,0,2,0.0,1.0,0.0
A06753,5,5,0,10,0.5,0.5,0.0
A06754,5,8,0,13,0.38,0.62,0.0
A06755,1,6,0,7,0.14,0.86,0.0
A06758,3,1,0,4,0.75,0.25,0.0
A06759,13,8,0,21,0.62,0.38,0.0
A06761,0,4,0,4,0.0,1.0,0.0
A06762,0,1,0,1,0.0,1.0,0.0
A06763,0,4,0,4,0.0,1.0,0.0
A06764,0,1,0,1,0.0,1.0,0.0
A06765,1,3,0,4,0.25,0.75,0.0
A06766,0,3,0,3,0.0,1.0,0.0
A06767,3,3,0,6,0.5,0.5,0.0
A06768,0,3,0,3,0.0,1.0,0.0
A06769,1,7,0,8,0.12,0.88,0.0
A06770,0,8,0,8,0.0,1.0,0.0
A06771,3,3,0,6,0.5,0.5,0.0
A06772,9,37,0,46,0.2,0.8,0.0
A06774,0,3,0,3,0.0,1.0,0.0
A06775,0,3,0,3,0.0,1.0,0.0
A06776,10,6,0,16,0.62,0.38,0.0
A06777,1,3,0,4,0.25,0.75,0.0
A06778,1,10,0,11,0.09,0.91,0.0
A06781,0,2,0,2,0.0,1.0,0.0
A06783,2,6,0,8,0.25,0.75,0.0
A06784,0,3,0,3,0.0,1.0,0.0
A06785,0,2,0,2,0.0,1.0,0.0
A06786,0,1,0,1,0.0,1.0,0.0
A06787,2,2,0,4,0.5,0.5,0.0
A06788,9,6,0,15,0.6,0.4,0.0
A06789,4,9,0,13,0.31,0.69,0.0
A06790,3,8,0,11,0.27,0.73,0.0
A06791,1,1,0,2,0.5,0.5,0.0
A06792,0,2,0,2,0.0,1.0,0.0
A06793,1,6,0,7,0.14,0.86,0.0
A06794,10,8,0,18,0.56,0.44,0.0
A06795,0,1,0,1,0.0,1.0,0.0
A06796,0,4,0,4,0.0,1.0,0.0
A06797,2,3,0,5,0.4,0.6,0.0
A06798,4,7,0,11,0.36,0.64,0.0
A06799,1,5,0,6,0.17,0.83,0.0
A06800,5,6,0,11,0.45,0.55,0.0
A06801,1,3,0,4,0.25,0.75,0.0
A06802,1,5,0,6,0.17,0.83,0.0
A06803,2,1,0,3,0.67,0.33,0.0
A06804,0,2,0,2,0.0,1.0,0.0
A06805,1,4,0,5,0.2,0.8,0.0
A06806,1,8,0,9,0.11,0.89,0.0
A06807,1,3,0,4,0.25,0.75,0.0
A06809,3,8,0,11,0.27,0.73,0.0
A06812,7,14,0,21,0.33,0.67,0.0
A06813,1,2,0,3,0.33,0.67,0.0
A06814,1,2,0,3,0.33,0.67,0.0
A06816,2,0,0,2,1.0,0.0,0.0
A06817,2,1,0,3,0.67,0.33,0.0
A06819,0,1,0,1,0.0,1.0,0.0
A06821,7,19,0,26,0.27,0.73,0.0
A06823,2,1,0,3,0.67,0.33,0.0
A06827,2,7,0,9,0.22,0.78,0.0
A06828,5,6,0,11,0.45,0.55,0.0
A06830,0,2,0,2,0.0,1.0,0.0
A06831,0,5,0,5,0.0,1.0,0.0
A06832,1,2,0,3,0.33,0.67,0.0
A06833,5,6,0,11,0.45,0.55,0.0
A06834,8,12,0,20,0.4,0.6,0.0
A06835,3,4,0,7,0.43,0.57,0.0
A06836,2,11,0,13,0.15,0.85,0.0
A06837,1,0,0,1,1.0,0.0,0.0
A06838,1,0,0,1,1.0,0.0,0.0
A06839,1,4,0,5,0.2,0.8,0.0
A06840,10,8,0,18,0.56,0.44,0.0
A06841,15,28,0,43,0.35,0.65,0.0
A06842,1,6,0,7,0.14,0.86,0.0
A06843,5,7,0,12,0.42,0.58,0.0
A06844,10,20,0,30,0.33,0.67,0.0
A06845,23,31,0,54,0.43,0.57,0.0
A06846,4,2,0,6,0.67,0.33,0.0
A06847,3,7,0,10,0.3,0.7,0.0
A06848,2,12,0,14,0.14,0.86,0.0
A06849,7,13,0,20,0.35,0.65,0.0
A06850,1,4,0,5,0.2,0.8,0.0
A06851,2,1,0,3,0.67,0.33,0.0
A06852,0,7,0,7,0.0,1.0,0.0
A06853,37,6,0,43,0.86,0.14,0.0
A06854,1,7,0,8,0.12,0.88,0.0
A06855,2,4,0,6,0.33,0.67,0.0
A06856,8,4,0,12,0.67,0.33,0.0
A06857,18,3,0,21,0.86,0.14,0.0
A06858,1,1,0,2,0.5,0.5,0.0
A06859,1,7,0,8,0.12,0.88,0.0
A06860,1,11,0,12,0.08,0.92,0.0
A06861,13,9,0,22,0.59,0.41,0.0
A06862,16,18,0,34,0.47,0.53,0.0
A06863,12,11,0,23,0.52,0.48,0.0
A06864,4,4,0,8,0.5,0.5,0.0
A06865,0,2,0,2,0.0,1.0,0.0
A06866,1,4,0,5,0.2,0.8,0.0
A06867,0,1,0,1,0.0,1.0,0.0
A06868,7,9,0,16,0.44,0.56,0.0
A06869,1,6,0,7,0.14,0.86,0.0
A06870,0,3,0,3,0.0,1.0,0.0
A06871,4,10,0,14,0.29,0.71,0.0
A06872,1,4,0,5,0.2,0.8,0.0
A06873,2,0,0,2,1.0,0.0,0.0
A06874,9,11,0,20,0.45,0.55,0.0
A06877,2,0,0,2,1.0,0.0,0.0
A06878,0,3,0,3,0.0,1.0,0.0
A06879,0,8,0,8,0.0,1.0,0.0
A06880,0,1,0,1,0.0,1.0,0.0
A06881,0,2,0,2,0.0,1.0,0.0
A06882,4,7,0,11,0.36,0.64,0.0
A06883,0,3,0,3,0.0,1.0,0.0
A06884,2,3,0,5,0.4,0.6,0.0
A06885,4,5,0,9,0.44,0.56,0.0
A06886,2,5,0,7,0.29,0.71,0.0
A06887,1,1,0,2,0.5,0.5,0.0
A06888,1,4,0,5,0.2,0.8,0.0
A06889,0,1,0,1,0.0,1.0,0.0
A06890,0,4,0,4,0.0,1.0,0.0
A06891,0,4,0,4,0.0,1.0,0.0
A06892,2,1,0,3,0.67,0.33,0.0
A06895,6,4,0,10,0.6,0.4,0.0
A06896,0,1,0,1,0.0,1.0,0.0
A06898,10,12,0,22,0.45,0.55,0.0
A06901,6,8,0,14,0.43,0.57,0.0
A06902,0,5,0,5,0.0,1.0,0.0
A06903,13,18,0,31,0.42,0.58,0.0
A06904,16,7,0,23,0.7,0.3,0.0
A06906,0,2,0,2,0.0,1.0,0.0
A06907,8,4,0,12,0.67,0.33,0.0
A06908,0,2,0,2,0.0,1.0,0.0
A06909,14,6,0,20,0.7,0.3,0.0
A06910,2,9,0,11,0.18,0.82,0.0
A06911,1,2,0,3,0.33,0.67,0.0
A06912,0,1,0,1,0.0,1.0,0.0
A06913,0,2,0,2,0.0,1.0,0.0
A06914,16,23,0,39,0.41,0.59,0.0
A06915,5,13,0,18,0.28,0.72,0.0
A06917,1,4,0,5,0.2,0.8,0.0
A06918,6,10,0,16,0.38,0.62,0.0
A06919,0,6,0,6,0.0,1.0,0.0
A06920,0,1,0,1,0.0,1.0,0.0
A06921,5,8,0,13,0.38,0.62,0.0
A06923,0,2,0,2,0.0,1.0,0.0
A06924,6,5,0,11,0.55,0.45,0.0
A06925,2,0,0,2,1.0,0.0,0.0
A06929,1,0,0,1,1.0,0.0,0.0
A06930,1,3,0,4,0.25,0.75,0.0
A06931,0,5,0,5,0.0,1.0,0.0
A06932,1,4,0,5,0.2,0.8,0.0
A06933,0,7,0,7,0.0,1.0,0.0
A06934,0,1,0,1,0.0,1.0,0.0
A06935,6,14,0,20,0.3,0.7,0.0
A06936,0,2,0,2,0.0,1.0,0.0
A06937,3,10,0,13,0.23,0.77,0.0
A06939,0,3,0,3,0.0,1.0,0.0
A06940,0,3,0,3,0.0,1.0,0.0
A06941,15,26,0,41,0.37,0.63,0.0
A06942,1,1,0,2,0.5,0.5,0.0
A06944,0,12,0,12,0.0,1.0,0.0
A06945,0,3,0,3,0.0,1.0,0.0
A06946,0,1,0,1,0.0,1.0,0.0
A06947,1,1,0,2,0.5,0.5,0.0
A06949,4,1,0,5,0.8,0.2,0.0
A06950,0,4,0,4,0.0,1.0,0.0
A06951,0,2,0,2,0.0,1.0,0.0
A06952,3,7,0,10,0.3,0.7,0.0
A06953,1,0,0,1,1.0,0.0,0.0
A06954,0,2,0,2,0.0,1.0,0.0
A06955,1,3,0,4,0.25,0.75,0.0
A06956,0,2,0,2,0.0,1.0,0.0
A06957,2,12,0,14,0.14,0.86,0.0
A06958,0,2,0,2,0.0,1.0,0.0
A06960,1,2,0,3,0.33,0.67,0.0
A06961,1,1,0,2,0.5,0.5,0.0
A06962,1,0,0,1,1.0,0.0,0.0
A06963,1,4,0,5,0.2,0.8,0.0
A06964,2,3,0,5,0.4,0.6,0.0
A06965,0,2,0,2,0.0,1.0,0.0
A06966,0,4,0,4,0.0,1.0,0.0
A06967,0,2,0,2,0.0,1.0,0.0
A06968,3,22,0,25,0.12,0.88,0.0
A06970,11,12,0,23,0.48,0.52,0.0
A06971,0,4,0,4,0.0,1.0,0.0
A06972,4,8,0,12,0.33,0.67,0.0
A06973,5,9,0,14,0.36,0.64,0.0
A06975,6,18,0,24,0.25,0.75,0.0
A06976,2,0,0,2,1.0,0.0,0.0
A06977,0,2,0,2,0.0,1.0,0.0
A06978,6,8,0,14,0.43,0.57,0.0
A06981,2,3,0,5,0.4,0.6,0.0
A06982,8,4,0,12,0.67,0.33,0.0
A06984,1,1,0,2,0.5,0.5,0.0
A06985,0,3,0,3,0.0,1.0,0.0
A06986,0,4,0,4,0.0,1.0,0.0
A06987,0,3,0,3,0.0,1.0,0.0
A06988,2,4,0,6,0.33,0.67,0.0
A06991,1,2,0,3,0.33,0.67,0.0
A06992,0,3,0,3,0.0,1.0,0.0
A06993,0,2,0,2,0.0,1.0,0.0
A06994,1,5,0,6,0.17,0.83,0.0
A06995,1,4,0,5,0.2,0.8,0.0
A06996,3,5,0,8,0.38,0.62,0.0
A06998,2,2,0,4,0.5,0.5,0.0
A07000,0,2,0,2,0.0,1.0,0.0
A07001,14,11,0,25,0.56,0.44,0.0
A07002,4,1,0,5,0.8,0.2,0.0
A07003,0,1,0,1,0.0,1.0,0.0
A07004,0,1,0,1,0.0,1.0,0.0
A07005,0,10,0,10,0.0,1.0,0.0
A07006,0,2,0,2,0.0,1.0,0.0
A07007,3,12,0,15,0.2,0.8,0.0
A07008,0,1,0,1,0.0,1.0,0.0
A07010,2,0,0,2,1.0,0.0,0.0
A07011,2,7,0,9,0.22,0.78,0.0
A07013,4,3,0,7,0.57,0.43,0.0
A07014,5,3,0,8,0.62,0.38,0.0
A07015,0,3,0,3,0.0,1.0,0.0
A07016,1,5,0,6,0.17,0.83,0.0
A07017,0,3,0,3,0.0,1.0,0.0
A07018,5,4,0,9,0.56,0.44,0.0
A07019,4,15,0,19,0.21,0.79,0.0
A07020,0,1,0,1,0.0,1.0,0.0
A07024,0,2,0,2,0.0,1.0,0.0
A07025,10,7,0,17,0.59,0.41,0.0
A07026,2,2,0,4,0.5,0.5,0.0
A07027,4,6,0,10,0.4,0.6,0.0
A07028,5,6,0,11,0.45,0.55,0.0
A07030,3,7,0,10,0.3,0.7,0.0
A07031,1,4,0,5,0.2,0.8,0.0
A07032,0,5,0,5,0.0,1.0,0.0
A07033,7,10,0,17,0.41,0.59,0.0
A07034,1,4,0,5,0.2,0.8,0.0
A07035,1,5,0,6,0.17,0.83,0.0
A07036,0,2,0,2,0.0,1.0,0.0
A07038,0,2,0,2,0.0,1.0,0.0
A07039,3,13,0,16,0.19,0.81,0.0
A07040,2,6,0,8,0.25,0.75,0.0
A07041,4,7,0,11,0.36,0.64,0.0
A07042,1,0,0,1,1.0,0.0,0.0
A07043,0,1,0,1,0.0,1.0,0.0
A07044,8,11,0,19,0.42,0.58,0.0
A07045,0,2,0,2,0.0,1.0,0.0
A07046,0,5,0,5,0.0,1.0,0.0
A07047,0,1,0,1,0.0,1.0,0.0
A07051,0,1,0,1,0.0,1.0,0.0
A07055,7,22,0,29,0.24,0.76,0.0
A07056,2,8,0,10,0.2,0.8,0.0
A07057,1,4,0,5,0.2,0.8,0.0
A07058,1,4,0,5,0.2,0.8,0.0
A07059,0,7,0,7,0.0,1.0,0.0
A07060,2,7,0,9,0.22,0.78,0.0
A07067,0,3,0,3,0.0,1.0,0.0
A07068,0,3,0,3,0.0,1.0,0.0
A07069,21,10,0,31,0.68,0.32,0.0
A07070,9,19,0,28,0.32,0.68,0.0
A07071,3,7,0,10,0.3,0.7,0.0
A07072,1,3,0,4,0.25,0.75,0.0
A07073,0,1,0,1,0.0,1.0,0.0
A07074,7,7,1,15,0.47,0.47,0.07
A07076,0,5,0,5,0.0,1.0,0.0
A07077,2,9,0,11,0.18,0.82,0.0
A07078,1,5,0,6,0.17,0.83,0.0
A07079,68,75,0,143,0.48,0.52,0.0
A07080,1,1,0,2,0.5,0.5,0.0
A07082,3,1,0,4,0.75,0.25,0.0
A07083,0,7,0,7,0.0,1.0,0.0
A07084,9,1,0,10,0.9,0.1,0.0
A07085,3,5,0,8,0.38,0.62,0.0
A07086,0,3,0,3,0.0,1.0,0.0
A07087,1,0,0,1,1.0,0.0,0.0
A07088,1,5,0,6,0.17,0.83,0.0
A07089,2,0,0,2,1.0,0.0,0.0
A07090,1,4,0,5,0.2,0.8,0.0
A07091,16,10,0,26,0.62,0.38,0.0
A07092,0,1,0,1,0.0,1.0,0.0
A07093,1,2,0,3,0.33,0.67,0.0
A07094,3,5,0,8,0.38,0.62,0.0
A07095,1,1,0,2,0.5,0.5,0.0
A07096,0,3,0,3,0.0,1.0,0.0
A07097,15,12,0,27,0.56,0.44,0.0
A07099,2,12,0,14,0.14,0.86,0.0
A07100,12,9,0,21,0.57,0.43,0.0
A07101,2,2,0,4,0.5,0.5,0.0
A07102,1,1,0,2,0.5,0.5,0.0
A07104,0,6,0,6,0.0,1.0,0.0
A07106,3,10,0,13,0.23,0.77,0.0
A07107,1,6,0,7,0.14,0.86,0.0
A07108,0,5,0,5,0.0,1.0,0.0
A07109,1,1,0,2,0.5,0.5,0.0
A07110,0,2,0,2,0.0,1.0,0.0
A07112,0,3,0,3,0.0,1.0,0.0
A07113,1,5,0,6,0.17,0.83,0.0
A07115,0,1,0,1,0.0,1.0,0.0
A07116,4,8,0,12,0.33,0.67,0.0
A07117,1,3,0,4,0.25,0.75,0.0
A07118,0,1,0,1,0.0,1.0,0.0
A07119,17,13,0,30,0.57,0.43,0.0
A07120,5,5,0,10,0.5,0.5,0.0
A07121,1,5,0,6,0.17,0.83,0.0
A07122,1,5,0,6,0.17,0.83,0.0
A07123,2,5,0,7,0.29,0.71,0.0
A07124,12,24,0,36,0.33,0.67,0.0
A07125,0,2,0,2,0.0,1.0,0.0
A07127,2,11,0,13,0.15,0.85,0.0
A07129,7,4,0,11,0.64,0.36,0.0
A07130,6,11,0,17,0.35,0.65,0.0
A07131,1,5,0,6,0.17,0.83,0.0
A07133,3,0,0,3,1.0,0.0,0.0
A07135,67,21,0,88,0.76,0.24,0.0
A07136,0,1,0,1,0.0,1.0,0.0
A07138,3,17,0,20,0.15,0.85,0.0
A07139,2,3,0,5,0.4,0.6,0.0
A07140,15,13,1,29,0.52,0.45,0.03
A07141,2,7,0,9,0.22,0.78,0.0
A07142,0,1,0,1,0.0,1.0,0.0
A07147,0,2,0,2,0.0,1.0,0.0
A07148,0,2,0,2,0.0,1.0,0.0
A07149,4,6,0,10,0.4,0.6,0.0
A07150,4,4,0,8,0.5,0.5,0.0
A07151,3,4,0,7,0.43,0.57,0.0
A07152,1,0,0,1,1.0,0.0,0.0
A07154,17,4,0,21,0.81,0.19,0.0
A07155,14,6,0,20,0.7,0.3,0.0
A07156,14,21,0,35,0.4,0.6,0.0
A07157,1,4,0,5,0.2,0.8,0.0
A07158,0,5,0,5,0.0,1.0,0.0
A07161,0,4,0,4,0.0,1.0,0.0
A07162,0,1,0,1,0.0,1.0,0.0
A07163,22,10,0,32,0.69,0.31,0.0
A07165,1,2,0,3,0.33,0.67,0.0
A07166,1,7,0,8,0.12,0.88,0.0
A07167,0,1,0,1,0.0,1.0,0.0
A07168,1,3,0,4,0.25,0.75,0.0
A07170,0,1,0,1,0.0,1.0,0.0
A07171,0,2,0,2,0.0,1.0,0.0
A07172,3,11,0,14,0.21,0.79,0.0
A07174,1,0,0,1,1.0,0.0,0.0
A07175,72,21,0,93,0.77,0.23,0.0
A07176,0,1,0,1,0.0,1.0,0.0
A07177,16,6,0,22,0.73,0.27,0.0
A07178,2,3,0,5,0.4,0.6,0.0
A07179,0,2,0,2,0.0,1.0,0.0
A07180,40,25,1,66,0.61,0.38,0.02
A07181,2,0,0,2,1.0,0.0,0.0
A07182,30,4,0,34,0.88,0.12,0.0
A07184,18,2,0,20,0.9,0.1,0.0
A07185,47,33,0,80,0.59,0.41,0.0
A07186,3,7,0,10,0.3,0.7,0.0
A07187,3,2,0,5,0.6,0.4,0.0
A07188,8,20,0,28,0.29,0.71,0.0
A07189,2,20,0,22,0.09,0.91,0.0
A07190,1,2,0,3,0.33,0.67,0.0
A07191,0,1,0,1,0.0,1.0,0.0
A07192,5,1,0,6,0.83,0.17,0.0
A07193,37,13,1,51,0.73,0.25,0.02
A07194,17,3,0,20,0.85,0.15,0.0
A07195,4,5,2,11,0.36,0.45,0.18
A07196,2,1,0,3,0.67,0.33,0.0
A07197,7,5,0,12,0.58,0.42,0.0
A07198,3,8,0,11,0.27,0.73,0.0
A07199,0,1,0,1,0.0,1.0,0.0
A07201,5,14,0,19,0.26,0.74,0.0
A07202,4,8,1,13,0.31,0.62,0.08
A07203,8,7,0,15,0.53,0.47,0.0
A07204,7,8,0,15,0.47,0.53,0.0
A07205,2,18,0,20,0.1,0.9,0.0
A07206,0,3,0,3,0.0,1.0,0.0
A07208,3,5,0,8,0.38,0.62,0.0
A07209,1,2,0,3,0.33,0.67,0.0
A07210,1,4,0,5,0.2,0.8,0.0
A07211,1,1,0,2,0.5,0.5,0.0
A07212,1,4,0,5,0.2,0.8,0.0
A07213,2,0,0,2,1.0,0.0,0.0
A07214,5,23,0,28,0.18,0.82,0.0
A07215,2,7,0,9,0.22,0.78,0.0
A07216,0,1,0,1,0.0,1.0,0.0
A07217,0,7,0,7,0.0,1.0,0.0
A07218,1,1,0,2,0.5,0.5,0.0
A07219,0,1,0,1,0.0,1.0,0.0
A07220,0,5,0,5,0.0,1.0,0.0
A07221,15,11,0,26,0.58,0.42,0.0
A07222,0,5,0,5,0.0,1.0,0.0
A07223,70,16,0,86,0.81,0.19,0.0
A07224,0,1,0,1,0.0,1.0,0.0
A07225,0,1,0,1,0.0,1.0,0.0
A07226,0,1,0,1,0.0,1.0,0.0
A07227,7,6,0,13,0.54,0.46,0.0
A07228,1,3,0,4,0.25,0.75,0.0
A07232,0,1,0,1,0.0,1.0,0.0
A07233,2,2,0,4,0.5,0.5,0.0
A07234,4,11,0,15,0.27,0.73,0.0
A07235,2,0,0,2,1.0,0.0,0.0
A07236,1,6,0,7,0.14,0.86,0.0
A07237,11,20,0,31,0.35,0.65,0.0
A07238,0,2,0,2,0.0,1.0,0.0
A07239,1,0,0,1,1.0,0.0,0.0
A07240,2,0,0,2,1.0,0.0,0.0
A07241,1,8,0,9,0.11,0.89,0.0
A07242,0,1,0,1,0.0,1.0,0.0
A07244,1,3,0,4,0.25,0.75,0.0
A07245,6,8,0,14,0.43,0.57,0.0
A07246,3,3,0,6,0.5,0.5,0.0
A07248,3,3,0,6,0.5,0.5,0.0
A07251,3,12,0,15,0.2,0.8,0.0
A07252,1,4,0,5,0.2,0.8,0.0
A07253,2,6,0,8,0.25,0.75,0.0
A07254,1,3,0,4,0.25,0.75,0.0
A07255,4,5,0,9,0.44,0.56,0.0
A07256,0,1,0,1,0.0,1.0,0.0
A07257,1,6,0,7,0.14,0.86,0.0
A07258,3,5,0,8,0.38,0.62,0.0
A07259,6,5,0,11,0.55,0.45,0.0
A07260,5,10,0,15,0.33,0.67,0.0
A07261,0,4,0,4,0.0,1.0,0.0
A07262,0,5,0,5,0.0,1.0,0.0
A07263,2,1,0,3,0.67,0.33,0.0
A07264,1,1,0,2,0.5,0.5,0.0
A07265,1,4,0,5,0.2,0.8,0.0
A07266,0,2,0,2,0.0,1.0,0.0
A07267,2,1,0,3,0.67,0.33,0.0
A07268,4,8,0,12,0.33,0.67,0.0
A07269,0,1,0,1,0.0,1.0,0.0
A07270,3,3,0,6,0.5,0.5,0.0
A07274,1,4,0,5,0.2,0.8,0.0
A07275,3,1,0,4,0.75,0.25,0.0
A07276,18,17,0,35,0.51,0.49,0.0
A07277,2,1,0,3,0.67,0.33,0.0
A07278,0,1,0,1,0.0,1.0,0.0
A07279,1,0,0,1,1.0,0.0,0.0
A07280,2,5,0,7,0.29,0.71,0.0
A07281,3,0,0,3,1.0,0.0,0.0
A07282,0,1,0,1,0.0,1.0,0.0
A07284,1,6,0,7,0.14,0.86,0.0
A07285,3,2,0,5,0.6,0.4,0.0
A07286,0,2,0,2,0.0,1.0,0.0
A07287,1,5,0,6,0.17,0.83,0.0
A07290,1,5,0,6,0.17,0.83,0.0
A07291,2,6,0,8,0.25,0.75,0.0
A07292,0,1,0,1,0.0,1.0,0.0
A07294,4,1,0,5,0.8,0.2,0.0
A07298,1,2,0,3,0.33,0.67,0.0
A07299,0,1,0,1,0.0,1.0,0.0
A07300,1,6,0,7,0.14,0.86,0.0
A07301,0,6,0,6,0.0,1.0,0.0
A07302,8,5,0,13,0.62,0.38,0.0
A07303,2,4,0,6,0.33,0.67,0.0
A07304,3,12,0,15,0.2,0.8,0.0
A07305,4,5,0,9,0.44,0.56,0.0
A07306,0,6,0,6,0.0,1.0,0.0
A07307,0,7,0,7,0.0,1.0,0.0
A07308,2,0,0,2,1.0,0.0,0.0
A07312,7,11,0,18,0.39,0.61,0.0
A07316,7,8,0,15,0.47,0.53,0.0
A07317,0,6,0,6,0.0,1.0,0.0
A07318,1,2,0,3,0.33,0.67,0.0
A07320,0,1,0,1,0.0,1.0,0.0
A07321,1,6,0,7,0.14,0.86,0.0
A07324,0,1,0,1,0.0,1.0,0.0
A07326,5,3,0,8,0.62,0.38,0.0
A07327,3,3,0,6,0.5,0.5,0.0
A07329,16,7,0,23,0.7,0.3,0.0
A07330,2,4,0,6,0.33,0.67,0.0
A07331,0,1,0,1,0.0,1.0,0.0
A07335,0,1,0,1,0.0,1.0,0.0
A07336,0,1,0,1,0.0,1.0,0.0
A07337,1,4,0,5,0.2,0.8,0.0
A07340,0,8,0,8,0.0,1.0,0.0
A07341,1,10,0,11,0.09,0.91,0.0
A07343,6,11,0,17,0.35,0.65,0.0
A07344,7,11,0,18,0.39,0.61,0.0
A07346,0,2,0,2,0.0,1.0,0.0
A07347,1,3,0,4,0.25,0.75,0.0
A07348,4,3,0,7,0.57,0.43,0.0
A07349,1,2,0,3,0.33,0.67,0.0
A07350,0,3,0,3,0.0,1.0,0.0
A07351,3,11,0,14,0.21,0.79,0.0
A07352,2,1,0,3,0.67,0.33,0.0
A07353,1,6,0,7,0.14,0.86,0.0
A07355,3,3,0,6,0.5,0.5,0.0
A07356,16,9,0,25,0.64,0.36,0.0
A07357,0,4,0,4,0.0,1.0,0.0
A07358,2,3,0,5,0.4,0.6,0.0
A07359,0,1,0,1,0.0,1.0,0.0
A07364,10,23,0,33,0.3,0.7,0.0
A07367,0,1,0,1,0.0,1.0,0.0
A07368,0,3,0,3,0.0,1.0,0.0
A07369,1,1,0,2,0.5,0.5,0.0
A07371,2,9,0,11,0.18,0.82,0.0
A07379,0,1,0,1,0.0,1.0,0.0
A07380,9,7,0,16,0.56,0.44,0.0
A07381,14,10,0,24,0.58,0.42,0.0
A07382,1,2,0,3,0.33,0.67,0.0
A07384,12,10,0,22,0.55,0.45,0.0
A07385,0,9,0,9,0.0,1.0,0.0
A07386,2,1,0,3,0.67,0.33,0.0
A07387,6,14,0,20,0.3,0.7,0.0
A07389,1,4,0,5,0.2,0.8,0.0
A07390,4,8,0,12,0.33,0.67,0.0
A07391,0,6,0,6,0.0,1.0,0.0
A07392,10,13,0,23,0.43,0.57,0.0
A07393,0,2,0,2,0.0,1.0,0.0
A07394,2,12,0,14,0.14,0.86,0.0
A07395,2,1,0,3,0.67,0.33,0.0
A07411,0,5,0,5,0.0,1.0,0.0
A07412,22,8,0,30,0.73,0.27,0.0
A07413,7,13,2,22,0.32,0.59,0.09
A07414,1,0,0,1,1.0,0.0,0.0
A07420,0,1,0,1,0.0,1.0,0.0
A07421,0,1,0,1,0.0,1.0,0.0
A07423,2,2,0,4,0.5,0.5,0.0
A07425,0,1,0,1,0.0,1.0,0.0
A07432,0,1,0,1,0.0,1.0,0.0
A07433,0,1,0,1,0.0,1.0,0.0
A07434,0,2,0,2,0.0,1.0,0.0
A07435,0,5,0,5,0.0,1.0,0.0
A07436,7,9,0,16,0.44,0.56,0.0
A07437,1,1,0,2,0.5,0.5,0.0
A07438,20,8,0,28,0.71,0.29,0.0
A07439,1,1,0,2,0.5,0.5,0.0
A07440,2,1,0,3,0.67,0.33,0.0
A07441,1,3,0,4,0.25,0.75,0.0
A07442,7,2,0,9,0.78,0.22,0.0
A07443,0,6,0,6,0.0,1.0,0.0
A07444,2,0,0,2,1.0,0.0,0.0
A07445,1,7,0,8,0.12,0.88,0.0
A07446,0,4,0,4,0.0,1.0,0.0
A07447,0,1,0,1,0.0,1.0,0.0
A07448,1,4,0,5,0.2,0.8,0.0
A07450,0,1,0,1,0.0,1.0,0.0
A07453,19,15,0,34,0.56,0.44,0.0
A07454,0,5,0,5,0.0,1.0,0.0
A07455,3,3,0,6,0.5,0.5,0.0
A07457,0,4,0,4,0.0,1.0,0.0
A07460,0,2,0,2,0.0,1.0,0.0
A07462,0,2,0,2,0.0,1.0,0.0
A07465,1,5,0,6,0.17,0.83,0.0
A07466,2,3,0,5,0.4,0.6,0.0
A07468,0,2,0,2,0.0,1.0,0.0
A07474,0,2,0,2,0.0,1.0,0.0
A07476,1,4,0,5,0.2,0.8,0.0
A07477,4,3,0,7,0.57,0.43,0.0
A07478,2,0,0,2,1.0,0.0,0.0
A07479,0,1,0,1,0.0,1.0,0.0
A07480,1,0,0,1,1.0,0.0,0.0
A07481,3,10,0,13,0.23,0.77,0.0
A07482,0,2,0,2,0.0,1.0,0.0
A07484,2,2,0,4,0.5,0.5,0.0
A07485,1,2,0,3,0.33,0.67,0.0
A07486,0,2,0,2,0.0,1.0,0.0
A07489,4,18,0,22,0.18,0.82,0.0
A07490,11,8,0,19,0.58,0.42,0.0
A07491,2,6,0,8,0.25,0.75,0.0
A07492,1,6,0,7,0.14,0.86,0.0
A07497,9,5,0,14,0.64,0.36,0.0
A07498,3,3,0,6,0.5,0.5,0.0
A07499,2,5,0,7,0.29,0.71,0.0
A07500,0,1,0,1,0.0,1.0,0.0
A07501,5,7,0,12,0.42,0.58,0.0
A07502,2,2,0,4,0.5,0.5,0.0
A07503,1,5,0,6,0.17,0.83,0.0
A07504,4,4,0,8,0.5,0.5,0.0
A07505,3,2,0,5,0.6,0.4,0.0
A07506,0,1,0,1,0.0,1.0,0.0
A07507,27,19,0,46,0.59,0.41,0.0
A07510,0,5,0,5,0.0,1.0,0.0
A07511,6,12,0,18,0.33,0.67,0.0
A07515,2,1,0,3,0.67,0.33,0.0
A07516,1,2,0,3,0.33,0.67,0.0
A07517,2,0,0,2,1.0,0.0,0.0
A07518,0,3,0,3,0.0,1.0,0.0
A07519,0,2,0,2,0.0,1.0,0.0
A07520,0,1,0,1,0.0,1.0,0.0
A07522,3,3,0,6,0.5,0.5,0.0
A07523,1,4,0,5,0.2,0.8,0.0
A07524,2,2,0,4,0.5,0.5,0.0
A07526,0,4,0,4,0.0,1.0,0.0
A07529,4,1,0,5,0.8,0.2,0.0
A07530,0,2,0,2,0.0,1.0,0.0
A07532,7,7,0,14,0.5,0.5,0.0
A07534,2,6,0,8,0.25,0.75,0.0
A07535,7,8,0,15,0.47,0.53,0.0
A07536,8,8,0,16,0.5,0.5,0.0
A07537,0,3,0,3,0.0,1.0,0.0
A07538,2,2,0,4,0.5,0.5,0.0
A07539,1,1,0,2,0.5,0.5,0.0
A07541,6,6,0,12,0.5,0.5,0.0
A07542,1,2,0,3,0.33,0.67,0.0
A07543,2,2,0,4,0.5,0.5,0.0
A07544,2,6,1,9,0.22,0.67,0.11
A07545,10,9,2,21,0.48,0.43,0.1
A07547,2,2,0,4,0.5,0.5,0.0
A07549,0,2,0,2,0.0,1.0,0.0
A07550,2,6,0,8,0.25,0.75,0.0
A07552,1,3,0,4,0.25,0.75,0.0
A07553,1,2,0,3,0.33,0.67,0.0
A07554,0,2,0,2,0.0,1.0,0.0
A07556,5,2,1,8,0.62,0.25,0.12
A07557,0,2,0,2,0.0,1.0,0.0
A07558,0,4,0,4,0.0,1.0,0.0
A07560,2,6,0,8,0.25,0.75,0.0
A07563,9,32,0,41,0.22,0.78,0.0
A07564,2,1,0,3,0.67,0.33,0.0
A07567,0,4,0,4,0.0,1.0,0.0
A07568,12,7,0,19,0.63,0.37,0.0
A07569,0,1,0,1,0.0,1.0,0.0
A07570,1,0,0,1,1.0,0.0,0.0
A07572,1,7,0,8,0.12,0.88,0.0
A07573,7,8,0,15,0.47,0.53,0.0
A07574,1,1,0,2,0.5,0.5,0.0
A07575,8,11,0,19,0.42,0.58,0.0
A07578,0,1,0,1,0.0,1.0,0.0
A07579,1,7,0,8,0.12,0.88,0.0
A07580,0,1,0,1,0.0,1.0,0.0
A07581,1,8,0,9,0.11,0.89,0.0
A07582,5,3,0,8,0.62,0.38,0.0
A07584,1,8,0,9,0.11,0.89,0.0
A07585,4,8,0,12,0.33,0.67,0.0
A07587,18,10,0,28,0.64,0.36,0.0
A07588,74,18,0,92,0.8,0.2,0.0
A07589,4,1,0,5,0.8,0.2,0.0
A07590,2,2,0,4,0.5,0.5,0.0
A07592,4,8,0,12,0.33,0.67,0.0
A07593,27,17,0,44,0.61,0.39,0.0
A07594,23,16,0,39,0.59,0.41,0.0
A07595,1,4,0,5,0.2,0.8,0.0
A07596,0,4,0,4,0.0,1.0,0.0
A07597,1,2,0,3,0.33,0.67,0.0
A07598,1,0,0,1,1.0,0.0,0.0
A07599,0,1,0,1,0.0,1.0,0.0
A07600,0,1,0,1,0.0,1.0,0.0
A07601,0,1,0,1,0.0,1.0,0.0
A07602,1,0,0,1,1.0,0.0,0.0
A07603,11,11,0,22,0.5,0.5,0.0
A07604,5,12,0,17,0.29,0.71,0.0
A07605,5,12,0,17,0.29,0.71,0.0
A07606,0,1,0,1,0.0,1.0,0.0
A07607,24,21,0,45,0.53,0.47,0.0
A07608,6,7,0,13,0.46,0.54,0.0
A07611,0,7,0,7,0.0,1.0,0.0
A07612,0,4,0,4,0.0,1.0,0.0
A07613,0,3,0,3,0.0,1.0,0.0
A07614,11,11,0,22,0.5,0.5,0.0
A07615,0,7,0,7,0.0,1.0,0.0
A07616,0,5,0,5,0.0,1.0,0.0
A07617,6,25,0,31,0.19,0.81,0.0
A07618,8,11,0,19,0.42,0.58,0.0
A07619,6,6,0,12,0.5,0.5,0.0
A07620,3,11,0,14,0.21,0.79,0.0
A07622,1,7,0,8,0.12,0.88,0.0
A07623,2,3,0,5,0.4,0.6,0.0
A07624,0,4,0,4,0.0,1.0,0.0
A07625,0,7,0,7,0.0,1.0,0.0
A07626,0,1,0,1,0.0,1.0,0.0
A07627,0,3,0,3,0.0,1.0,0.0
A07628,2,5,0,7,0.29,0.71,0.0
A07629,17,19,0,36,0.47,0.53,0.0
A07630,1,2,0,3,0.33,0.67,0.0
A07631,1,5,0,6,0.17,0.83,0.0
A07632,9,13,0,22,0.41,0.59,0.0
A07633,1,6,0,7,0.14,0.86,0.0
A07634,2,7,0,9,0.22,0.78,0.0
A07635,1,1,0,2,0.5,0.5,0.0
A07636,6,3,0,9,0.67,0.33,0.0
A07637,3,2,0,5,0.6,0.4,0.0
A07638,1,5,0,6,0.17,0.83,0.0
A07639,0,2,0,2,0.0,1.0,0.0
A07640,0,2,0,2,0.0,1.0,0.0
A07643,3,3,0,6,0.5,0.5,0.0
A07645,2,7,0,9,0.22,0.78,0.0
A07646,0,2,0,2,0.0,1.0,0.0
A07648,0,4,0,4,0.0,1.0,0.0
A07649,2,0,0,2,1.0,0.0,0.0
A07650,0,1,0,1,0.0,1.0,0.0
A07651,0,3,0,3,0.0,1.0,0.0
A07652,6,13,0,19,0.32,0.68,0.0
A07654,6,10,0,16,0.38,0.62,0.0
A07656,9,9,0,18,0.5,0.5,0.0
A07657,0,8,0,8,0.0,1.0,0.0
A07658,0,1,0,1,0.0,1.0,0.0
A07659,8,21,0,29,0.28,0.72,0.0
A07661,0,1,0,1,0.0,1.0,0.0
A07662,0,1,0,1,0.0,1.0,0.0
A07663,6,9,0,15,0.4,0.6,0.0
A07664,7,8,0,15,0.47,0.53,0.0
A07665,1,1,0,2,0.5,0.5,0.0
A07666,1,0,0,1,1.0,0.0,0.0
A07667,1,0,0,1,1.0,0.0,0.0
A07668,0,9,0,9,0.0,1.0,0.0
A07670,6,8,0,14,0.43,0.57,0.0
A07672,15,8,0,23,0.65,0.35,0.0
A07673,0,3,0,3,0.0,1.0,0.0
A07674,0,1,0,1,0.0,1.0,0.0
A07675,1,0,0,1,1.0,0.0,0.0
A07676,0,1,0,1,0.0,1.0,0.0
A07678,0,2,0,2,0.0,1.0,0.0
A07679,0,1,0,1,0.0,1.0,0.0
A07680,1,5,0,6,0.17,0.83,0.0
A07681,7,10,0,17,0.41,0.59,0.0
A07682,0,2,0,2,0.0,1.0,0.0
A07683,0,7,0,7,0.0,1.0,0.0
A07684,2,3,0,5,0.4,0.6,0.0
A07685,5,3,0,8,0.62,0.38,0.0
A07690,4,32,0,36,0.11,0.89,0.0
A07691,0,4,0,4,0.0,1.0,0.0
A07692,0,3,0,3,0.0,1.0,0.0
A07693,0,1,0,1,0.0,1.0,0.0
A07694,0,2,0,2,0.0,1.0,0.0
A07697,0,1,0,1,0.0,1.0,0.0
A07699,0,5,0,5,0.0,1.0,0.0
A07700,2,2,0,4,0.5,0.5,0.0
A07701,0,1,0,1,0.0,1.0,0.0
A07702,0,1,0,1,0.0,1.0,0.0
A07705,3,5,0,8,0.38,0.62,0.0
A07707,5,16,0,21,0.24,0.76,0.0
A07709,2,13,0,15,0.13,0.87,0.0
A07710,13,16,0,29,0.45,0.55,0.0
A07711,1,2,0,3,0.33,0.67,0.0
A07712,1,1,0,2,0.5,0.5,0.0
A07713,4,5,0,9,0.44,0.56,0.0
A07715,0,2,0,2,0.0,1.0,0.0
A07716,5,6,1,12,0.42,0.5,0.08
A07717,0,1,0,1,0.0,1.0,0.0
A07718,1,5,0,6,0.17,0.83,0.0
A07719,0,3,0,3,0.0,1.0,0.0
A07721,1,1,0,2,0.5,0.5,0.0
A07722,2,3,0,5,0.4,0.6,0.0
A07724,1,0,0,1,1.0,0.0,0.0
A07726,1,3,0,4,0.25,0.75,0.0
A07727,5,7,0,12,0.42,0.58,0.0
A07729,1,1,0,2,0.5,0.5,0.0
A07730,1,7,0,8,0.12,0.88,0.0
A07731,8,13,0,21,0.38,0.62,0.0
A07732,15,9,0,24,0.62,0.38,0.0
A07733,0,2,0,2,0.0,1.0,0.0
A07734,0,6,0,6,0.0,1.0,0.0
A07736,2,2,0,4,0.5,0.5,0.0
A07737,2,4,0,6,0.33,0.67,0.0
A07738,0,3,0,3,0.0,1.0,0.0
A07739,3,6,0,9,0.33,0.67,0.0
A07740,11,13,0,24,0.46,0.54,0.0
A07741,3,9,0,12,0.25,0.75,0.0
A07742,0,1,0,1,0.0,1.0,0.0
A07743,3,1,0,4,0.75,0.25,0.0
A07744,22,10,1,33,0.67,0.3,0.03
A07745,1,2,0,3,0.33,0.67,0.0
A07746,15,19,1,35,0.43,0.54,0.03
A07747,11,5,0,16,0.69,0.31,0.0
A07748,0,7,0,7,0.0,1.0,0.0
A07749,0,1,0,1,0.0,1.0,0.0
A07750,2,3,0,5,0.4,0.6,0.0
A07751,0,2,0,2,0.0,1.0,0.0
A07752,1,3,0,4,0.25,0.75,0.0
A07753,8,8,0,16,0.5,0.5,0.0
A07755,6,10,0,16,0.38,0.62,0.0
A07756,0,1,0,1,0.0,1.0,0.0
A07757,0,2,0,2,0.0,1.0,0.0
A07758,0,2,0,2,0.0,1.0,0.0
A07760,0,1,0,1,0.0,1.0,0.0
A07761,0,1,0,1,0.0,1.0,0.0
A07765,2,0,0,2,1.0,0.0,0.0
A07766,116,49,4,169,0.69,0.29,0.02
A07767,2,5,0,7,0.29,0.71,0.0
A07768,3,14,0,17,0.18,0.82,0.0
A07769,0,2,0,2,0.0,1.0,0.0
A07770,7,5,0,12,0.58,0.42,0.0
A07771,4,2,0,6,0.67,0.33,0.0
A07772,5,16,0,21,0.24,0.76,0.0
A07773,3,4,0,7,0.43,0.57,0.0
A07776,1,3,0,4,0.25,0.75,0.0
A07777,14,18,0,32,0.44,0.56,0.0
A07778,4,10,0,14,0.29,0.71,0.0
A07779,1,6,0,7,0.14,0.86,0.0
A07782,0,3,0,3,0.0,1.0,0.0
A07783,0,1,0,1,0.0,1.0,0.0
A07784,0,4,0,4,0.0,1.0,0.0
A07785,1,1,0,2,0.5,0.5,0.0
A07786,5,10,0,15,0.33,0.67,0.0
A07787,1,3,0,4,0.25,0.75,0.0
A07788,0,1,0,1,0.0,1.0,0.0
A07789,0,2,0,2,0.0,1.0,0.0
A07790,0,6,0,6,0.0,1.0,0.0
A07791,0,1,0,1,0.0,1.0,0.0
A07794,4,11,1,16,0.25,0.69,0.06
A07795,1,2,0,3,0.33,0.67,0.0
A07797,3,9,0,12,0.25,0.75,0.0
A07798,2,4,0,6,0.33,0.67,0.0
A07799,4,16,0,20,0.2,0.8,0.0
A07800,23,9,17,49,0.47,0.18,0.35
A07801,6,9,0,15,0.4,0.6,0.0
A07802,18,7,0,25,0.72,0.28,0.0
A07803,3,4,0,7,0.43,0.57,0.0
A07804,43,6,10,59,0.73,0.1,0.17
A07805,9,10,0,19,0.47,0.53,0.0
A07806,24,7,3,34,0.71,0.21,0.09
A07807,12,6,0,18,0.67,0.33,0.0
A07808,1,0,0,1,1.0,0.0,0.0
A07809,0,2,0,2,0.0,1.0,0.0
A07810,8,8,0,16,0.5,0.5,0.0
A07814,1,1,0,2,0.5,0.5,0.0
A07815,24,16,0,40,0.6,0.4,0.0
A07816,0,6,0,6,0.0,1.0,0.0
A07817,0,1,0,1,0.0,1.0,0.0
A07819,10,8,0,18,0.56,0.44,0.0
A07820,1,3,0,4,0.25,0.75,0.0
A07822,5,11,0,16,0.31,0.69,0.0
A07823,5,12,0,17,0.29,0.71,0.0
A07824,1,3,0,4,0.25,0.75,0.0
A07825,0,2,0,2,0.0,1.0,0.0
A07826,0,1,0,1,0.0,1.0,0.0
A07828,0,2,0,2,0.0,1.0,0.0
A07829,0,1,0,1,0.0,1.0,0.0
A07830,0,9,0,9,0.0,1.0,0.0
A07831,6,7,0,13,0.46,0.54,0.0
A07832,3,93,0,96,0.03,0.97,0.0
A07834,1,2,0,3,0.33,0.67,0.0
A07835,1,1,0,2,0.5,0.5,0.0
A07836,1,2,0,3,0.33,0.67,0.0
A07838,0,4,0,4,0.0,1.0,0.0
A07840,0,1,0,1,0.0,1.0,0.0
A07841,0,3,0,3,0.0,1.0,0.0
A07842,1,2,0,3,0.33,0.67,0.0
A07843,3,2,0,5,0.6,0.4,0.0
A07844,1,2,0,3,0.33,0.67,0.0
A07845,1,0,0,1,1.0,0.0,0.0
A07849,13,2,0,15,0.87,0.13,0.0
A07850,2,5,0,7,0.29,0.71,0.0
A07851,24,17,0,41,0.59,0.41,0.0
A07852,10,26,0,36,0.28,0.72,0.0
A07853,17,21,0,38,0.45,0.55,0.0
A07854,161,91,2,254,0.63,0.36,0.01
A07855,11,3,0,14,0.79,0.21,0.0
A07859,4,9,0,13,0.31,0.69,0.0
A07860,0,2,0,2,0.0,1.0,0.0
A07861,9,13,0,22,0.41,0.59,0.0
A07864,2,8,0,10,0.2,0.8,0.0
A07865,2,4,0,6,0.33,0.67,0.0
A07866,1,4,0,5,0.2,0.8,0.0
A07868,2,3,0,5,0.4,0.6,0.0
A07870,0,3,0,3,0.0,1.0,0.0
A07871,5,8,0,13,0.38,0.62,0.0
A07872,1,3,0,4,0.25,0.75,0.0
A07873,7,5,0,12,0.58,0.42,0.0
A07874,1,2,0,3,0.33,0.67,0.0
A07876,2,1,0,3,0.67,0.33,0.0
A07877,6,7,0,13,0.46,0.54,0.0
A07878,0,1,0,1,0.0,1.0,0.0
A07881,2,5,0,7,0.29,0.71,0.0
A07882,0,1,0,1,0.0,1.0,0.0
A07883,0,5,0,5,0.0,1.0,0.0
A07884,2,3,0,5,0.4,0.6,0.0
A07885,0,1,0,1,0.0,1.0,0.0
A07886,3,3,0,6,0.5,0.5,0.0
A07887,2,2,0,4,0.5,0.5,0.0
A07888,1,2,0,3,0.33,0.67,0.0
A07889,0,2,0,2,0.0,1.0,0.0
A07890,1,2,0,3,0.33,0.67,0.0
A07892,17,14,0,31,0.55,0.45,0.0
A07893,15,10,0,25,0.6,0.4,0.0
A07894,20,14,0,34,0.59,0.41,0.0
A07895,2,4,0,6,0.33,0.67,0.0
A07896,3,6,0,9,0.33,0.67,0.0
A07898,0,1,0,1,0.0,1.0,0.0
A07899,1,1,0,2,0.5,0.5,0.0
A07900,7,6,0,13,0.54,0.46,0.0
A07901,0,1,1,2,0.0,0.5,0.5
A07902,7,8,0,15,0.47,0.53,0.0
A07903,2,1,0,3,0.67,0.33,0.0
A07904,1,6,0,7,0.14,0.86,0.0
A07905,1,3,0,4,0.25,0.75,0.0
A07906,11,6,0,17,0.65,0.35,0.0
A07907,160,44,0,204,0.78,0.22,0.0
A07908,1,4,0,5,0.2,0.8,0.0
A07909,1,5,0,6,0.17,0.83,0.0
A07910,8,7,0,15,0.53,0.47,0.0
A07912,7,5,0,12,0.58,0.42,0.0
A07913,33,20,0,53,0.62,0.38,0.0
A07914,5,5,0,10,0.5,0.5,0.0
A07915,0,4,0,4,0.0,1.0,0.0
A07916,5,2,0,7,0.71,0.29,0.0
A07917,0,2,0,2,0.0,1.0,0.0
A07918,2,2,0,4,0.5,0.5,0.0
A07919,1,5,0,6,0.17,0.83,0.0
A07920,8,8,1,17,0.47,0.47,0.06
A07921,1,6,0,7,0.14,0.86,0.0
A07922,1,2,0,3,0.33,0.67,0.0
A07923,1,4,0,5,0.2,0.8,0.0
A07924,1,4,0,5,0.2,0.8,0.0
A07925,4,3,0,7,0.57,0.43,0.0
A07926,2,3,0,5,0.4,0.6,0.0
A07927,43,9,3,55,0.78,0.16,0.05
A07928,11,6,0,17,0.65,0.35,0.0
A07929,2,6,0,8,0.25,0.75,0.0
A07930,6,3,0,9,0.67,0.33,0.0
A07933,12,7,0,19,0.63,0.37,0.0
A07934,2,4,0,6,0.33,0.67,0.0
A07935,2,0,0,2,1.0,0.0,0.0
A07936,1,1,0,2,0.5,0.5,0.0
A07937,3,6,0,9,0.33,0.67,0.0
A07938,0,3,0,3,0.0,1.0,0.0
A07940,2,4,0,6,0.33,0.67,0.0
A07941,4,5,0,9,0.44,0.56,0.0
A07942,0,1,0,1,0.0,1.0,0.0
A07943,0,2,0,2,0.0,1.0,0.0
A07944,2,5,0,7,0.29,0.71,0.0
A07945,4,2,0,6,0.67,0.33,0.0
A07946,2,0,0,2,1.0,0.0,0.0
A07947,3,2,0,5,0.6,0.4,0.0
A07948,0,1,0,1,0.0,1.0,0.0
A07949,2,1,0,3,0.67,0.33,0.0
A07950,15,9,0,24,0.62,0.38,0.0
A07952,8,11,0,19,0.42,0.58,0.0
A07953,0,3,0,3,0.0,1.0,0.0
A07954,8,7,0,15,0.53,0.47,0.0
A07957,1,1,0,2,0.5,0.5,0.0
A07958,5,3,0,8,0.62,0.38,0.0
A07959,9,11,0,20,0.45,0.55,0.0
A07960,0,1,0,1,0.0,1.0,0.0
A07962,4,9,0,13,0.31,0.69,0.0
A07963,7,8,0,15,0.47,0.53,0.0
A07964,0,4,0,4,0.0,1.0,0.0
A07965,3,10,0,13,0.23,0.77,0.0
A07966,4,8,0,12,0.33,0.67,0.0
A07967,6,9,0,15,0.4,0.6,0.0
A07968,5,8,0,13,0.38,0.62,0.0
A07970,21,17,0,38,0.55,0.45,0.0
A07971,1,3,0,4,0.25,0.75,0.0
A07972,2,1,0,3,0.67,0.33,0.0
A07973,9,11,0,20,0.45,0.55,0.0
A07974,6,6,0,12,0.5,0.5,0.0
A07976,1,2,0,3,0.33,0.67,0.0
A07977,0,3,0,3,0.0,1.0,0.0
A07978,6,14,0,20,0.3,0.7,0.0
A07979,1,2,0,3,0.33,0.67,0.0
A07980,1,1,0,2,0.5,0.5,0.0
A07981,7,5,0,12,0.58,0.42,0.0
A07982,1,0,0,1,1.0,0.0,0.0
A07983,0,1,0,1,0.0,1.0,0.0
A07984,0,2,0,2,0.0,1.0,0.0
A07986,6,6,0,12,0.5,0.5,0.0
A07987,1,4,0,5,0.2,0.8,0.0
A07988,1,1,0,2,0.5,0.5,0.0
A07990,1,3,0,4,0.25,0.75,0.0
A07991,3,3,0,6,0.5,0.5,0.0
A07992,1,0,0,1,1.0,0.0,0.0
A07993,7,9,0,16,0.44,0.56,0.0
A07994,0,2,0,2,0.0,1.0,0.0
A07995,1,1,0,2,0.5,0.5,0.0
A07996,2,6,0,8,0.25,0.75,0.0
A07997,13,9,0,22,0.59,0.41,0.0
A07999,3,0,0,3,1.0,0.0,0.0
A08002,1,1,0,2,0.5,0.5,0.0
A08003,2,6,0,8,0.25,0.75,0.0
A08004,1,1,0,2,0.5,0.5,0.0
A08005,3,4,0,7,0.43,0.57,0.0
A08006,13,19,1,33,0.39,0.58,0.03
A08007,8,9,5,22,0.36,0.41,0.23
A08009,0,5,0,5,0.0,1.0,0.0
A08010,0,1,0,1,0.0,1.0,0.0
A08011,3,3,0,6,0.5,0.5,0.0
A08012,1,1,0,2,0.5,0.5,0.0
A08013,12,7,0,19,0.63,0.37,0.0
A08014,5,1,0,6,0.83,0.17,0.0
A08015,0,3,0,3,0.0,1.0,0.0
A08018,1,0,0,1,1.0,0.0,0.0
A08019,16,7,0,23,0.7,0.3,0.0
A08020,2,2,0,4,0.5,0.5,0.0
A08021,0,2,0,2,0.0,1.0,0.0
A08022,7,8,0,15,0.47,0.53,0.0
A08023,11,6,0,17,0.65,0.35,0.0
A08026,0,1,0,1,0.0,1.0,0.0
A08027,8,8,0,16,0.5,0.5,0.0
A08029,19,9,0,28,0.68,0.32,0.0
A08030,5,11,0,16,0.31,0.69,0.0
A08031,2,1,0,3,0.67,0.33,0.0
A08032,0,1,0,1,0.0,1.0,0.0
A08033,1,8,0,9,0.11,0.89,0.0
A08034,9,11,0,20,0.45,0.55,0.0
A08035,1,3,0,4,0.25,0.75,0.0
A08036,10,11,0,21,0.48,0.52,0.0
A08037,0,5,0,5,0.0,1.0,0.0
A08038,0,3,0,3,0.0,1.0,0.0
A08040,2,0,0,2,1.0,0.0,0.0
A08041,5,2,0,7,0.71,0.29,0.0
A08042,5,9,0,14,0.36,0.64,0.0
A08043,5,0,0,5,1.0,0.0,0.0
A08045,0,1,0,1,0.0,1.0,0.0
A08047,5,2,0,7,0.71,0.29,0.0
A08050,5,7,0,12,0.42,0.58,0.0
A08051,3,3,0,6,0.5,0.5,0.0
A08052,0,1,0,1,0.0,1.0,0.0
A08053,2,5,0,7,0.29,0.71,0.0
A08054,9,6,0,15,0.6,0.4,0.0
A08055,0,7,0,7,0.0,1.0,0.0
A08056,1,7,0,8,0.12,0.88,0.0
A08057,2,0,0,2,1.0,0.0,0.0
A08058,0,1,0,1,0.0,1.0,0.0
A08059,3,3,0,6,0.5,0.5,0.0
A08060,0,9,0,9,0.0,1.0,0.0
A08061,1,5,0,6,0.17,0.83,0.0
A08062,3,1,0,4,0.75,0.25,0.0
A08063,0,5,0,5,0.0,1.0,0.0
A08064,1,1,0,2,0.5,0.5,0.0
A08065,10,3,0,13,0.77,0.23,0.0
A08067,0,2,0,2,0.0,1.0,0.0
A08068,11,13,0,24,0.46,0.54,0.0
A08069,2,6,0,8,0.25,0.75,0.0
A08070,10,21,0,31,0.32,0.68,0.0
A08072,0,1,0,1,0.0,1.0,0.0
A08073,1,7,0,8,0.12,0.88,0.0
A08074,8,4,0,12,0.67,0.33,0.0
A08075,2,4,0,6,0.33,0.67,0.0
A08076,0,2,0,2,0.0,1.0,0.0
A08078,4,5,0,9,0.44,0.56,0.0
A08079,5,10,0,15,0.33,0.67,0.0
A08080,0,2,0,2,0.0,1.0,0.0
A08081,0,1,0,1,0.0,1.0,0.0
A08082,7,6,0,13,0.54,0.46,0.0
A08084,0,6,0,6,0.0,1.0,0.0
A08085,1,1,0,2,0.5,0.5,0.0
A08086,6,7,0,13,0.46,0.54,0.0
A08087,1,2,0,3,0.33,0.67,0.0
A08089,3,6,0,9,0.33,0.67,0.0
A08090,1,0,0,1,1.0,0.0,0.0
A08092,4,3,0,7,0.57,0.43,0.0
A08093,0,1,0,1,0.0,1.0,0.0
A08094,1,0,0,1,1.0,0.0,0.0
A08095,4,2,0,6,0.67,0.33,0.0
A08096,0,1,0,1,0.0,1.0,0.0
A08097,0,4,0,4,0.0,1.0,0.0
A08098,8,5,0,13,0.62,0.38,0.0
A08100,4,5,0,9,0.44,0.56,0.0
A08101,0,4,0,4,0.0,1.0,0.0
A08102,8,4,0,12,0.67,0.33,0.0
A08103,1,5,0,6,0.17,0.83,0.0
A08105,10,7,0,17,0.59,0.41,0.0
A08109,1,0,0,1,1.0,0.0,0.0
A08110,16,11,0,27,0.59,0.41,0.0
A08111,12,8,0,20,0.6,0.4,0.0
A08112,3,2,0,5,0.6,0.4,0.0
A08113,2,1,0,3,0.67,0.33,0.0
A08114,10,4,0,14,0.71,0.29,0.0
A08115,3,3,0,6,0.5,0.5,0.0
A08117,59,30,0,89,0.66,0.34,0.0
A08118,0,2,0,2,0.0,1.0,0.0
A08119,1,2,0,3,0.33,0.67,0.0
A08121,19,11,0,30,0.63,0.37,0.0
A08122,17,13,0,30,0.57,0.43,0.0
A08123,2,5,0,7,0.29,0.71,0.0
A08124,2,2,0,4,0.5,0.5,0.0
A08125,0,2,0,2,0.0,1.0,0.0
A08126,0,1,0,1,0.0,1.0,0.0
A08127,1,2,0,3,0.33,0.67,0.0
A08128,29,19,0,48,0.6,0.4,0.0
A08129,2,2,0,4,0.5,0.5,0.0
A08130,0,2,0,2,0.0,1.0,0.0
A08131,3,9,0,12,0.25,0.75,0.0
A08132,3,6,0,9,0.33,0.67,0.0
A08133,21,18,0,39,0.54,0.46,0.0
A08134,0,1,0,1,0.0,1.0,0.0
A08135,0,5,0,5,0.0,1.0,0.0
A08136,12,5,0,17,0.71,0.29,0.0
A08137,9,5,0,14,0.64,0.36,0.0
A08138,10,4,0,14,0.71,0.29,0.0
A08139,83,42,0,125,0.66,0.34,0.0
A08140,11,9,0,20,0.55,0.45,0.0
A08141,20,16,0,36,0.56,0.44,0.0
A08142,23,5,0,28,0.82,0.18,0.0
A08143,13,9,0,22,0.59,0.41,0.0
A08144,1,2,0,3,0.33,0.67,0.0
A08145,4,5,0,9,0.44,0.56,0.0
A08146,10,11,0,21,0.48,0.52,0.0
A08147,0,3,0,3,0.0,1.0,0.0
A08148,2,2,0,4,0.5,0.5,0.0
A08149,2,10,0,12,0.17,0.83,0.0
A08150,11,11,0,22,0.5,0.5,0.0
A08151,3,5,0,8,0.38,0.62,0.0
A08152,1,1,0,2,0.5,0.5,0.0
A08153,61,11,0,72,0.85,0.15,0.0
A08154,15,6,0,21,0.71,0.29,0.0
A08155,16,6,0,22,0.73,0.27,0.0
A08156,4,8,0,12,0.33,0.67,0.0
A08157,9,4,0,13,0.69,0.31,0.0
A08158,4,5,0,9,0.44,0.56,0.0
A08159,3,3,0,6,0.5,0.5,0.0
A08160,9,14,0,23,0.39,0.61,0.0
A08161,2,6,0,8,0.25,0.75,0.0
A08162,18,14,0,32,0.56,0.44,0.0
A08163,7,10,0,17,0.41,0.59,0.0
A08164,3,0,0,3,1.0,0.0,0.0
A08165,7,8,0,15,0.47,0.53,0.0
A08166,2,2,0,4,0.5,0.5,0.0
A08167,0,4,0,4,0.0,1.0,0.0
A08168,16,4,0,20,0.8,0.2,0.0
A08169,6,3,0,9,0.67,0.33,0.0
A08170,8,6,0,14,0.57,0.43,0.0
A08171,2,4,0,6,0.33,0.67,0.0
A08172,5,9,0,14,0.36,0.64,0.0
A08173,1,3,0,4,0.25,0.75,0.0
A08176,10,9,0,19,0.53,0.47,0.0
A08177,4,1,0,5,0.8,0.2,0.0
A08178,3,3,0,6,0.5,0.5,0.0
A08179,1,7,0,8,0.12,0.88,0.0
A08180,9,6,0,15,0.6,0.4,0.0
A08181,5,12,0,17,0.29,0.71,0.0
A08182,10,12,0,22,0.45,0.55,0.0
A08183,12,7,0,19,0.63,0.37,0.0
A08184,1,2,0,3,0.33,0.67,0.0
A08185,0,2,0,2,0.0,1.0,0.0
A08186,1,3,0,4,0.25,0.75,0.0
A08187,0,6,0,6,0.0,1.0,0.0
A08188,7,9,0,16,0.44,0.56,0.0
A08189,0,3,0,3,0.0,1.0,0.0
A08192,1,0,0,1,1.0,0.0,0.0
A08193,5,9,0,14,0.36,0.64,0.0
A08194,16,20,0,36,0.44,0.56,0.0
A08195,19,6,0,25,0.76,0.24,0.0
A08196,1,1,0,2,0.5,0.5,0.0
A08198,0,1,0,1,0.0,1.0,0.0
A08199,12,8,0,20,0.6,0.4,0.0
A08200,0,2,0,2,0.0,1.0,0.0
A08201,7,5,0,12,0.58,0.42,0.0
A08202,11,9,0,20,0.55,0.45,0.0
A08203,34,46,0,80,0.42,0.57,0.0
A08205,15,3,0,18,0.83,0.17,0.0
A08208,18,9,0,27,0.67,0.33,0.0
A08209,1,1,0,2,0.5,0.5,0.0
A08210,2,1,0,3,0.67,0.33,0.0
A08211,5,4,0,9,0.56,0.44,0.0
A08212,0,2,0,2,0.0,1.0,0.0
A08213,0,3,0,3,0.0,1.0,0.0
A08214,0,1,0,1,0.0,1.0,0.0
A08215,0,2,0,2,0.0,1.0,0.0
A08216,11,14,1,26,0.42,0.54,0.04
A08219,9,7,0,16,0.56,0.44,0.0
A08221,0,6,0,6,0.0,1.0,0.0
A08222,1,1,0,2,0.5,0.5,0.0
A08223,1,7,0,8,0.12,0.88,0.0
A08225,2,5,0,7,0.29,0.71,0.0
A08226,1,1,0,2,0.5,0.5,0.0
A08227,8,4,0,12,0.67,0.33,0.0
A08228,2,7,0,9,0.22,0.78,0.0
A08231,6,6,0,12,0.5,0.5,0.0
A08232,0,3,0,3,0.0,1.0,0.0
A08233,6,3,0,9,0.67,0.33,0.0
A08234,0,1,0,1,0.0,1.0,0.0
A08235,1,4,0,5,0.2,0.8,0.0
A08236,0,2,0,2,0.0,1.0,0.0
A08237,16,12,0,28,0.57,0.43,0.0
A08238,7,6,0,13,0.54,0.46,0.0
A08239,0,3,0,3,0.0,1.0,0.0
A08240,0,3,0,3,0.0,1.0,0.0
A08241,1,5,0,6,0.17,0.83,0.0
A08242,4,8,0,12,0.33,0.67,0.0
A08243,9,5,0,14,0.64,0.36,0.0
A08244,0,9,0,9,0.0,1.0,0.0
A08245,16,30,1,47,0.34,0.64,0.02
A08246,9,5,0,14,0.64,0.36,0.0
A08247,3,2,0,5,0.6,0.4,0.0
A08248,1,2,0,3,0.33,0.67,0.0
A08249,2,3,0,5,0.4,0.6,0.0
A08250,0,1,0,1,0.0,1.0,0.0
A08251,3,1,0,4,0.75,0.25,0.0
A08252,2,7,0,9,0.22,0.78,0.0
A08253,6,6,0,12,0.5,0.5,0.0
A08254,0,1,0,1,0.0,1.0,0.0
A08255,6,8,0,14,0.43,0.57,0.0
A08256,0,1,0,1,0.0,1.0,0.0
A08257,6,4,0,10,0.6,0.4,0.0
A08258,2,6,0,8,0.25,0.75,0.0
A08259,0,2,0,2,0.0,1.0,0.0
A08260,4,8,0,12,0.33,0.67,0.0
A08261,0,3,0,3,0.0,1.0,0.0
A08263,21,5,0,26,0.81,0.19,0.0
A08264,0,3,0,3,0.0,1.0,0.0
A08265,0,2,0,2,0.0,1.0,0.0
A08267,7,11,0,18,0.39,0.61,0.0
A08268,0,3,0,3,0.0,1.0,0.0
A08269,2,3,0,5,0.4,0.6,0.0
A08270,10,3,0,13,0.77,0.23,0.0
A08272,1,1,0,2,0.5,0.5,0.0
A08273,1,4,0,5,0.2,0.8,0.0
A08274,1,1,0,2,0.5,0.5,0.0
A08275,6,6,0,12,0.5,0.5,0.0
A08277,0,5,0,5,0.0,1.0,0.0
A08280,0,1,0,1,0.0,1.0,0.0
A08281,14,5,0,19,0.74,0.26,0.0
A08283,1,5,0,6,0.17,0.83,0.0
A08284,3,1,0,4,0.75,0.25,0.0
A08285,1,2,0,3,0.33,0.67,0.0
A08286,0,6,0,6,0.0,1.0,0.0
A08287,2,2,0,4,0.5,0.5,0.0
A08288,2,3,0,5,0.4,0.6,0.0
A08289,0,4,0,4,0.0,1.0,0.0
A08290,5,4,0,9,0.56,0.44,0.0
A08293,2,1,0,3,0.67,0.33,0.0
A08294,30,14,0,44,0.68,0.32,0.0
A08295,13,7,0,20,0.65,0.35,0.0
A08296,8,22,0,30,0.27,0.73,0.0
A08297,2,5,0,7,0.29,0.71,0.0
A08298,12,7,0,19,0.63,0.37,0.0
A08300,2,3,0,5,0.4,0.6,0.0
A08301,44,19,0,63,0.7,0.3,0.0
A08302,29,9,0,38,0.76,0.24,0.0
A08303,1,1,0,2,0.5,0.5,0.0
A08304,1,5,0,6,0.17,0.83,0.0
A08306,3,3,0,6,0.5,0.5,0.0
A08307,4,10,0,14,0.29,0.71,0.0
A08308,1,2,0,3,0.33,0.67,0.0
A08310,19,3,0,22,0.86,0.14,0.0
A08311,2,2,0,4,0.5,0.5,0.0
A08312,1,7,0,8,0.12,0.88,0.0
A08313,13,5,0,18,0.72,0.28,0.0
A08314,1,2,0,3,0.33,0.67,0.0
A08315,9,12,0,21,0.43,0.57,0.0
A08316,2,6,0,8,0.25,0.75,0.0
A08317,2,1,0,3,0.67,0.33,0.0
A08318,46,13,0,59,0.78,0.22,0.0
A08320,2,2,0,4,0.5,0.5,0.0
A08322,0,2,0,2,0.0,1.0,0.0
A08323,9,6,0,15,0.6,0.4,0.0
A08324,2,2,0,4,0.5,0.5,0.0
A08326,1,1,0,2,0.5,0.5,0.0
A08327,4,4,0,8,0.5,0.5,0.0
A08332,2,4,0,6,0.33,0.67,0.0
A08334,2,0,0,2,1.0,0.0,0.0
A08336,0,1,0,1,0.0,1.0,0.0
A08341,1,6,0,7,0.14,0.86,0.0
A08342,2,7,0,9,0.22,0.78,0.0
A08343,1,1,0,2,0.5,0.5,0.0
A08345,1,0,0,1,1.0,0.0,0.0
A08350,0,2,0,2,0.0,1.0,0.0
A08351,0,1,0,1,0.0,1.0,0.0
A08352,3,1,0,4,0.75,0.25,0.0
A08353,4,3,0,7,0.57,0.43,0.0
A08354,0,1,0,1,0.0,1.0,0.0
A08355,2,5,0,7,0.29,0.71,0.0
A08357,0,5,0,5,0.0,1.0,0.0
A08358,5,3,0,8,0.62,0.38,0.0
A08359,15,8,0,23,0.65,0.35,0.0
A08360,3,2,0,5,0.6,0.4,0.0
A08363,20,11,0,31,0.65,0.35,0.0
A08364,2,4,0,6,0.33,0.67,0.0
A08365,0,3,0,3,0.0,1.0,0.0
A08366,17,8,0,25,0.68,0.32,0.0
A08367,15,13,0,28,0.54,0.46,0.0
A08368,6,3,0,9,0.67,0.33,0.0
A08369,1,1,0,2,0.5,0.5,0.0
A08370,5,9,0,14,0.36,0.64,0.0
A08371,6,1,0,7,0.86,0.14,0.0
A08373,11,8,0,19,0.58,0.42,0.0
A08374,3,2,0,5,0.6,0.4,0.0
A08375,6,21,0,27,0.22,0.78,0.0
A08376,5,4,0,9,0.56,0.44,0.0
A08377,2,2,0,4,0.5,0.5,0.0
A08378,0,1,0,1,0.0,1.0,0.0
A08379,19,3,0,22,0.86,0.14,0.0
A08380,1,4,0,5,0.2,0.8,0.0
A08381,0,1,0,1,0.0,1.0,0.0
A08382,5,7,0,12,0.42,0.58,0.0
A08383,2,3,0,5,0.4,0.6,0.0
A08384,2,2,0,4,0.5,0.5,0.0
A08385,2,3,0,5,0.4,0.6,0.0
A08386,5,3,0,8,0.62,0.38,0.0
A08387,10,4,0,14,0.71,0.29,0.0
A08388,2,3,0,5,0.4,0.6,0.0
A08389,3,3,0,6,0.5,0.5,0.0
A08390,15,3,0,18,0.83,0.17,0.0
A08391,1,1,0,2,0.5,0.5,0.0
A08393,13,27,0,40,0.33,0.68,0.0
A08394,0,3,0,3,0.0,1.0,0.0
A08395,10,2,0,12,0.83,0.17,0.0
A08396,5,9,0,14,0.36,0.64,0.0
A08398,1,1,0,2,0.5,0.5,0.0
A08399,1,4,0,5,0.2,0.8,0.0
A08400,3,1,0,4,0.75,0.25,0.0
A08401,1,2,0,3,0.33,0.67,0.0
A08402,1,2,0,3,0.33,0.67,0.0
A08404,18,20,0,38,0.47,0.53,0.0
A08405,0,4,0,4,0.0,1.0,0.0
A08406,2,3,0,5,0.4,0.6,0.0
A08407,3,6,0,9,0.33,0.67,0.0
A08408,5,2,0,7,0.71,0.29,0.0
A08409,9,7,0,16,0.56,0.44,0.0
A08410,13,31,0,44,0.3,0.7,0.0
A08411,2,4,0,6,0.33,0.67,0.0
A08413,2,3,0,5,0.4,0.6,0.0
A08415,3,3,0,6,0.5,0.5,0.0
A08417,9,3,0,12,0.75,0.25,0.0
A08418,4,4,0,8,0.5,0.5,0.0
A08419,7,5,0,12,0.58,0.42,0.0
A08420,1,0,0,1,1.0,0.0,0.0
A08421,1,1,0,2,0.5,0.5,0.0
A08423,1,1,0,2,0.5,0.5,0.0
A08424,2,2,0,4,0.5,0.5,0.0
A08425,1,2,0,3,0.33,0.67,0.0
A08427,3,6,0,9,0.33,0.67,0.0
A08428,10,12,0,22,0.45,0.55,0.0
A08429,5,4,0,9,0.56,0.44,0.0
A08431,1,1,0,2,0.5,0.5,0.0
A08433,0,1,0,1,0.0,1.0,0.0
A08434,0,2,0,2,0.0,1.0,0.0
A08435,4,4,0,8,0.5,0.5,0.0
A08436,0,1,0,1,0.0,1.0,0.0
A08438,0,3,0,3,0.0,1.0,0.0
A08439,0,1,0,1,0.0,1.0,0.0
A08441,0,1,0,1,0.0,1.0,0.0
A08442,0,2,0,2,0.0,1.0,0.0
A08443,6,7,0,13,0.46,0.54,0.0
A08445,2,4,0,6,0.33,0.67,0.0
A08446,9,8,0,17,0.53,0.47,0.0
A08449,6,15,0,21,0.29,0.71,0.0
A08450,11,8,0,19,0.58,0.42,0.0
A08451,7,7,0,14,0.5,0.5,0.0
A08452,2,0,0,2,1.0,0.0,0.0
A08453,0,2,0,2,0.0,1.0,0.0
A08454,3,6,0,9,0.33,0.67,0.0
A08455,0,1,0,1,0.0,1.0,0.0
A08456,0,2,0,2,0.0,1.0,0.0
A08457,3,0,0,3,1.0,0.0,0.0
A08458,8,9,0,17,0.47,0.53,0.0
A08459,3,6,0,9,0.33,0.67,0.0
A08460,22,7,0,29,0.76,0.24,0.0
A08461,15,5,0,20,0.75,0.25,0.0
A08462,0,1,0,1,0.0,1.0,0.0
A08465,25,3,0,28,0.89,0.11,0.0
A08466,0,1,0,1,0.0,1.0,0.0
A08467,58,10,0,68,0.85,0.15,0.0
A08468,14,8,0,22,0.64,0.36,0.0
A08469,2,2,0,4,0.5,0.5,0.0
A08470,1,2,0,3,0.33,0.67,0.0
A08471,10,8,0,18,0.56,0.44,0.0
A08472,1,2,0,3,0.33,0.67,0.0
A08473,4,5,0,9,0.44,0.56,0.0
A08474,1,0,0,1,1.0,0.0,0.0
A08475,0,3,0,3,0.0,1.0,0.0
A08478,3,2,0,5,0.6,0.4,0.0
A08479,0,1,0,1,0.0,1.0,0.0
A08482,16,5,0,21,0.76,0.24,0.0
A08483,1,0,0,1,1.0,0.0,0.0
A08484,1,2,0,3,0.33,0.67,0.0
A08486,0,1,0,1,0.0,1.0,0.0
A08487,1,2,0,3,0.33,0.67,0.0
A08489,0,1,0,1,0.0,1.0,0.0
A08490,0,3,0,3,0.0,1.0,0.0
A08491,3,4,0,7,0.43,0.57,0.0
A08492,0,1,0,1,0.0,1.0,0.0
A08493,1,1,0,2,0.5,0.5,0.0
A08494,2,1,0,3,0.67,0.33,0.0
A08495,3,11,0,14,0.21,0.79,0.0
A08497,2,1,0,3,0.67,0.33,0.0
A08499,1,5,0,6,0.17,0.83,0.0
A08500,2,3,0,5,0.4,0.6,0.0
A08501,27,12,0,39,0.69,0.31,0.0
A08502,0,1,0,1,0.0,1.0,0.0
A08503,1,5,0,6,0.17,0.83,0.0
A08504,2,3,0,5,0.4,0.6,0.0
A08505,1,2,0,3,0.33,0.67,0.0
A08506,4,9,0,13,0.31,0.69,0.0
A08507,85,67,0,152,0.56,0.44,0.0
A08509,1,2,0,3,0.33,0.67,0.0
A08510,15,5,0,20,0.75,0.25,0.0
A08511,3,3,0,6,0.5,0.5,0.0
A08512,8,15,0,23,0.35,0.65,0.0
A08513,2,2,0,4,0.5,0.5,0.0
A08514,6,8,0,14,0.43,0.57,0.0
A08515,18,5,0,23,0.78,0.22,0.0
A08516,0,1,0,1,0.0,1.0,0.0
A08517,8,10,0,18,0.44,0.56,0.0
A08518,1,1,0,2,0.5,0.5,0.0
A08519,61,8,0,69,0.88,0.12,0.0
A08520,2,0,0,2,1.0,0.0,0.0
A08521,3,3,0,6,0.5,0.5,0.0
A08523,1,1,0,2,0.5,0.5,0.0
A08524,10,21,0,31,0.32,0.68,0.0
A08525,0,1,0,1,0.0,1.0,0.0
A08526,1,0,0,1,1.0,0.0,0.0
A08527,44,6,0,50,0.88,0.12,0.0
A08528,0,4,0,4,0.0,1.0,0.0
A08529,3,10,0,13,0.23,0.77,0.0
A08530,18,12,0,30,0.6,0.4,0.0
A08531,1,5,0,6,0.17,0.83,0.0
A08532,5,1,0,6,0.83,0.17,0.0
A08533,14,3,0,17,0.82,0.18,0.0
A08534,11,7,0,18,0.61,0.39,0.0
A08535,217,137,0,354,0.61,0.39,0.0
A08536,0,2,0,2,0.0,1.0,0.0
A08537,2,2,0,4,0.5,0.5,0.0
A08538,0,9,0,9,0.0,1.0,0.0
A08539,3,3,0,6,0.5,0.5,0.0
A08540,4,15,0,19,0.21,0.79,0.0
A08541,0,3,0,3,0.0,1.0,0.0
A08542,21,28,0,49,0.43,0.57,0.0
A08543,14,6,0,20,0.7,0.3,0.0
A08544,0,2,0,2,0.0,1.0,0.0
A08545,0,4,0,4,0.0,1.0,0.0
A08547,167,107,0,274,0.61,0.39,0.0
A08548,0,8,0,8,0.0,1.0,0.0
A08549,78,44,0,122,0.64,0.36,0.0
A08550,0,2,0,2,0.0,1.0,0.0
A08551,3,2,0,5,0.6,0.4,0.0
A08552,0,5,0,5,0.0,1.0,0.0
A08553,4,1,0,5,0.8,0.2,0.0
A08554,0,11,0,11,0.0,1.0,0.0
A08555,2,1,0,3,0.67,0.33,0.0
A08556,6,7,0,13,0.46,0.54,0.0
A08557,4,15,0,19,0.21,0.79,0.0
A08559,0,1,0,1,0.0,1.0,0.0
A08560,1,3,0,4,0.25,0.75,0.0
A08561,1,3,0,4,0.25,0.75,0.0
A08562,8,5,0,13,0.62,0.38,0.0
A08563,4,5,0,9,0.44,0.56,0.0
A08564,9,12,0,21,0.43,0.57,0.0
A08565,5,4,0,9,0.56,0.44,0.0
A08567,2,1,0,3,0.67,0.33,0.0
A08568,7,9,0,16,0.44,0.56,0.0
A08569,3,5,0,8,0.38,0.62,0.0
A08570,7,8,0,15,0.47,0.53,0.0
A08571,3,1,0,4,0.75,0.25,0.0
A08572,2,3,0,5,0.4,0.6,0.0
A08573,0,2,0,2,0.0,1.0,0.0
A08574,6,2,0,8,0.75,0.25,0.0
A08575,3,9,0,12,0.25,0.75,0.0
A08576,2,3,0,5,0.4,0.6,0.0
A08577,13,8,0,21,0.62,0.38,0.0
A08579,2,6,0,8,0.25,0.75,0.0
A08580,5,11,0,16,0.31,0.69,0.0
A08581,1,1,0,2,0.5,0.5,0.0
A08582,3,4,0,7,0.43,0.57,0.0
A08584,0,5,0,5,0.0,1.0,0.0
A08585,0,5,0,5,0.0,1.0,0.0
A08586,2,3,0,5,0.4,0.6,0.0
A08587,0,1,0,1,0.0,1.0,0.0
A08589,7,5,0,12,0.58,0.42,0.0
A08590,1,4,0,5,0.2,0.8,0.0
A08591,0,1,0,1,0.0,1.0,0.0
A08592,9,19,0,28,0.32,0.68,0.0
A08593,2,3,0,5,0.4,0.6,0.0
A08594,0,4,0,4,0.0,1.0,0.0
A08595,25,10,0,35,0.71,0.29,0.0
A08597,0,3,0,3,0.0,1.0,0.0
A08598,9,7,0,16,0.56,0.44,0.0
A08600,1,3,0,4,0.25,0.75,0.0
A08601,9,4,0,13,0.69,0.31,0.0
A08603,0,1,0,1,0.0,1.0,0.0
A08604,1,4,0,5,0.2,0.8,0.0
A08605,6,7,0,13,0.46,0.54,0.0
A08606,23,49,0,72,0.32,0.68,0.0
A08609,4,1,0,5,0.8,0.2,0.0
A08610,6,0,0,6,1.0,0.0,0.0
A08611,3,3,0,6,0.5,0.5,0.0
A08612,7,13,0,20,0.35,0.65,0.0
A08614,11,3,0,14,0.79,0.21,0.0
A08615,1,3,0,4,0.25,0.75,0.0
A08616,1,2,0,3,0.33,0.67,0.0
A08617,0,4,0,4,0.0,1.0,0.0
A08618,2,13,0,15,0.13,0.87,0.0
A08620,2,2,0,4,0.5,0.5,0.0
A08622,5,7,0,12,0.42,0.58,0.0
A08623,0,5,0,5,0.0,1.0,0.0
A08624,1,2,0,3,0.33,0.67,0.0
A08625,2,3,0,5,0.4,0.6,0.0
A08626,3,9,0,12,0.25,0.75,0.0
A08627,1,2,0,3,0.33,0.67,0.0
A08628,0,7,0,7,0.0,1.0,0.0
A08629,3,10,0,13,0.23,0.77,0.0
A08631,0,4,0,4,0.0,1.0,0.0
A08632,5,4,0,9,0.56,0.44,0.0
A08633,5,10,0,15,0.33,0.67,0.0
A08634,1,7,0,8,0.12,0.88,0.0
A08635,4,1,0,5,0.8,0.2,0.0
A08636,12,13,0,25,0.48,0.52,0.0
A08637,0,4,0,4,0.0,1.0,0.0
A08638,9,15,0,24,0.38,0.62,0.0
A08639,8,8,0,16,0.5,0.5,0.0
A08640,7,2,0,9,0.78,0.22,0.0
A08641,15,2,0,17,0.88,0.12,0.0
A08642,0,1,0,1,0.0,1.0,0.0
A08645,9,12,0,21,0.43,0.57,0.0
A08646,13,0,0,13,1.0,0.0,0.0
A08647,1,1,1,3,0.33,0.33,0.33
A08648,6,6,0,12,0.5,0.5,0.0
A08650,25,17,0,42,0.6,0.4,0.0
A08651,1,8,0,9,0.11,0.89,0.0
A08652,8,14,0,22,0.36,0.64,0.0
A08653,1,5,0,6,0.17,0.83,0.0
A08654,1,1,0,2,0.5,0.5,0.0
A08656,0,2,0,2,0.0,1.0,0.0
A08657,8,16,0,24,0.33,0.67,0.0
A08658,4,9,0,13,0.31,0.69,0.0
A08659,1,3,0,4,0.25,0.75,0.0
A08660,1,2,0,3,0.33,0.67,0.0
A08661,2,3,0,5,0.4,0.6,0.0
A08662,0,1,0,1,0.0,1.0,0.0
A08664,17,35,0,52,0.33,0.67,0.0
A08666,1,0,0,1,1.0,0.0,0.0
A08667,6,6,0,12,0.5,0.5,0.0
A08668,2,4,0,6,0.33,0.67,0.0
A08669,3,5,0,8,0.38,0.62,0.0
A08670,6,8,0,14,0.43,0.57,0.0
A08671,4,3,0,7,0.57,0.43,0.0
A08672,1,4,0,5,0.2,0.8,0.0
A08673,5,9,0,14,0.36,0.64,0.0
A08674,0,2,0,2,0.0,1.0,0.0
A08675,0,1,0,1,0.0,1.0,0.0
A08676,6,7,0,13,0.46,0.54,0.0
A08677,1,2,0,3,0.33,0.67,0.0
A08678,0,3,0,3,0.0,1.0,0.0
A08679,0,1,0,1,0.0,1.0,0.0
A08680,2,5,0,7,0.29,0.71,0.0
A08683,1,2,0,3,0.33,0.67,0.0
A08686,0,1,0,1,0.0,1.0,0.0
A08687,0,3,0,3,0.0,1.0,0.0
A08688,2,13,0,15,0.13,0.87,0.0
A08691,0,1,0,1,0.0,1.0,0.0
A08692,25,191,3,219,0.11,0.87,0.01
A08693,0,6,0,6,0.0,1.0,0.0
A08695,2,4,0,6,0.33,0.67,0.0
A08696,2,13,0,15,0.13,0.87,0.0
A08697,1,0,0,1,1.0,0.0,0.0
A08698,1,0,0,1,1.0,0.0,0.0
A08699,0,1,0,1,0.0,1.0,0.0
A08700,0,3,0,3,0.0,1.0,0.0
A08702,1,5,0,6,0.17,0.83,0.0
A08704,0,1,0,1,0.0,1.0,0.0
A08705,1,0,0,1,1.0,0.0,0.0
A08706,2,15,0,17,0.12,0.88,0.0
A08708,2,13,0,15,0.13,0.87,0.0
A08709,0,5,0,5,0.0,1.0,0.0
A08710,0,1,0,1,0.0,1.0,0.0
A08711,1,6,0,7,0.14,0.86,0.0
A08712,0,1,0,1,0.0,1.0,0.0
A08713,0,1,0,1,0.0,1.0,0.0
A08714,0,2,0,2,0.0,1.0,0.0
A08716,3,10,0,13,0.23,0.77,0.0
A08717,0,1,0,1,0.0,1.0,0.0
A08719,5,4,0,9,0.56,0.44,0.0
A08720,5,15,0,20,0.25,0.75,0.0
A08721,6,8,0,14,0.43,0.57,0.0
A08722,1,3,0,4,0.25,0.75,0.0
A08724,15,10,0,25,0.6,0.4,0.0
A08725,2,2,0,4,0.5,0.5,0.0
A08727,5,2,0,7,0.71,0.29,0.0
A08728,6,2,0,8,0.75,0.25,0.0
A08729,1,3,0,4,0.25,0.75,0.0
A08730,0,1,0,1,0.0,1.0,0.0
A08731,1,2,0,3,0.33,0.67,0.0
A08732,32,15,11,58,0.55,0.26,0.19
A08734,7,10,0,17,0.41,0.59,0.0
A08735,8,12,0,20,0.4,0.6,0.0
A08736,6,9,0,15,0.4,0.6,0.0
A08737,1,8,0,9,0.11,0.89,0.0
A08738,9,4,0,13,0.69,0.31,0.0
A08739,0,1,0,1,0.0,1.0,0.0
A08741,5,2,0,7,0.71,0.29,0.0
A08742,23,5,0,28,0.82,0.18,0.0
A08743,12,16,0,28,0.43,0.57,0.0
A08744,0,1,0,1,0.0,1.0,0.0
A08745,20,6,0,26,0.77,0.23,0.0
A08746,1,2,0,3,0.33,0.67,0.0
A08747,6,9,0,15,0.4,0.6,0.0
A08748,0,1,0,1,0.0,1.0,0.0
A08749,0,1,0,1,0.0,1.0,0.0
A08750,6,16,0,22,0.27,0.73,0.0
A08751,2,3,0,5,0.4,0.6,0.0
A08752,0,1,0,1,0.0,1.0,0.0
A08753,10,13,0,23,0.43,0.57,0.0
A08754,0,4,0,4,0.0,1.0,0.0
A08755,2,3,0,5,0.4,0.6,0.0
A08756,4,5,0,9,0.44,0.56,0.0
A08757,0,1,0,1,0.0,1.0,0.0
A08758,0,1,0,1,0.0,1.0,0.0
A08759,18,11,0,29,0.62,0.38,0.0
A08760,0,1,0,1,0.0,1.0,0.0
A08761,2,7,0,9,0.22,0.78,0.0
A08762,26,2,0,28,0.93,0.07,0.0
A08763,6,7,0,13,0.46,0.54,0.0
A08764,9,10,0,19,0.47,0.53,0.0
A08766,2,1,0,3,0.67,0.33,0.0
A08767,1,7,0,8,0.12,0.88,0.0
A08770,1,7,0,8,0.12,0.88,0.0
A08771,8,10,0,18,0.44,0.56,0.0
A08772,39,16,0,55,0.71,0.29,0.0
A08773,1,5,0,6,0.17,0.83,0.0
A08774,0,4,0,4,0.0,1.0,0.0
A08775,4,0,0,4,1.0,0.0,0.0
A08779,5,1,0,6,0.83,0.17,0.0
A08781,5,8,0,13,0.38,0.62,0.0
A08784,6,16,0,22,0.27,0.73,0.0
A08785,1,1,0,2,0.5,0.5,0.0
A08786,4,3,0,7,0.57,0.43,0.0
A08787,4,12,0,16,0.25,0.75,0.0
A08788,9,8,0,17,0.53,0.47,0.0
A08789,0,1,0,1,0.0,1.0,0.0
A08790,7,11,0,18,0.39,0.61,0.0
A08791,3,4,0,7,0.43,0.57,0.0
A08792,0,1,0,1,0.0,1.0,0.0
A08793,1,0,0,1,1.0,0.0,0.0
A08794,6,3,0,9,0.67,0.33,0.0
A08795,0,2,0,2,0.0,1.0,0.0
A08796,0,1,0,1,0.0,1.0,0.0
A08797,15,47,6,68,0.22,0.69,0.09
A08798,0,2,0,2,0.0,1.0,0.0
A08799,9,12,0,21,0.43,0.57,0.0
A08800,3,0,0,3,1.0,0.0,0.0
A08801,2,6,0,8,0.25,0.75,0.0
A08803,6,13,0,19,0.32,0.68,0.0
A08804,5,10,0,15,0.33,0.67,0.0
A08805,9,15,0,24,0.38,0.62,0.0
A08806,1,1,0,2,0.5,0.5,0.0
A08807,1,3,0,4,0.25,0.75,0.0
A08808,24,8,0,32,0.75,0.25,0.0
A08809,1,0,0,1,1.0,0.0,0.0
A08811,0,1,0,1,0.0,1.0,0.0
A08812,0,1,0,1,0.0,1.0,0.0
A08813,0,4,0,4,0.0,1.0,0.0
A08814,1,1,0,2,0.5,0.5,0.0
A08815,6,15,0,21,0.29,0.71,0.0
A08816,0,5,0,5,0.0,1.0,0.0
A08817,9,8,0,17,0.53,0.47,0.0
A08819,3,1,0,4,0.75,0.25,0.0
A08820,5,4,0,9,0.56,0.44,0.0
A08821,1,6,0,7,0.14,0.86,0.0
A08822,3,4,0,7,0.43,0.57,0.0
A08824,8,9,0,17,0.47,0.53,0.0
A08825,2,2,0,4,0.5,0.5,0.0
A08827,8,12,0,20,0.4,0.6,0.0
A08828,0,4,0,4,0.0,1.0,0.0
A08829,2,4,1,7,0.29,0.57,0.14
A08830,0,3,0,3,0.0,1.0,0.0
A08831,1,1,0,2,0.5,0.5,0.0
A08832,5,9,0,14,0.36,0.64,0.0
A08833,1,2,0,3,0.33,0.67,0.0
A08834,0,1,0,1,0.0,1.0,0.0
A08835,10,5,0,15,0.67,0.33,0.0
A08836,2,3,0,5,0.4,0.6,0.0
A08838,5,3,0,8,0.62,0.38,0.0
A08840,4,1,0,5,0.8,0.2,0.0
A08841,1,4,0,5,0.2,0.8,0.0
A08842,1,4,0,5,0.2,0.8,0.0
A08843,5,4,0,9,0.56,0.44,0.0
A08844,15,4,0,19,0.79,0.21,0.0
A08846,0,1,0,1,0.0,1.0,0.0
A08847,22,9,0,31,0.71,0.29,0.0
A08848,0,1,0,1,0.0,1.0,0.0
A08849,2,4,0,6,0.33,0.67,0.0
A08850,3,3,0,6,0.5,0.5,0.0
A08851,13,4,0,17,0.76,0.24,0.0
A08852,9,9,0,18,0.5,0.5,0.0
A08853,2,5,0,7,0.29,0.71,0.0
A08854,3,9,0,12,0.25,0.75,0.0
A08855,7,6,0,13,0.54,0.46,0.0
A08856,1,2,0,3,0.33,0.67,0.0
A08857,1,3,0,4,0.25,0.75,0.0
A08858,0,1,0,1,0.0,1.0,0.0
A08861,4,3,0,7,0.57,0.43,0.0
A08862,9,7,0,16,0.56,0.44,0.0
A08864,0,1,0,1,0.0,1.0,0.0
A08865,0,5,0,5,0.0,1.0,0.0
A08866,1,6,0,7,0.14,0.86,0.0
A08867,6,14,0,20,0.3,0.7,0.0
A08868,1,4,0,5,0.2,0.8,0.0
A08869,3,3,0,6,0.5,0.5,0.0
A08870,9,13,0,22,0.41,0.59,0.0
A08871,3,1,0,4,0.75,0.25,0.0
A08872,1,1,0,2,0.5,0.5,0.0
A08873,11,12,0,23,0.48,0.52,0.0
A08874,3,2,0,5,0.6,0.4,0.0
A08876,0,5,0,5,0.0,1.0,0.0
A08877,10,8,0,18,0.56,0.44,0.0
A08878,4,4,0,8,0.5,0.5,0.0
A08879,3,2,0,5,0.6,0.4,0.0
A08880,3,3,0,6,0.5,0.5,0.0
A08881,2,1,0,3,0.67,0.33,0.0
A08882,2,1,0,3,0.67,0.33,0.0
A08883,2,4,0,6,0.33,0.67,0.0
A08885,2,12,0,14,0.14,0.86,0.0
A08887,2,2,0,4,0.5,0.5,0.0
A08888,2,6,0,8,0.25,0.75,0.0
A08889,8,6,0,14,0.57,0.43,0.0
A08890,2,4,0,6,0.33,0.67,0.0
A08891,20,13,0,33,0.61,0.39,0.0
A08892,40,15,0,55,0.73,0.27,0.0
A08893,9,8,0,17,0.53,0.47,0.0
A08894,1,2,0,3,0.33,0.67,0.0
A08895,0,1,0,1,0.0,1.0,0.0
A08897,2,0,0,2,1.0,0.0,0.0
A08898,2,3,1,6,0.33,0.5,0.17
A08899,20,12,1,33,0.61,0.36,0.03
A08900,4,0,0,4,1.0,0.0,0.0
A08901,4,2,0,6,0.67,0.33,0.0
A08902,4,4,0,8,0.5,0.5,0.0
A08904,16,13,0,29,0.55,0.45,0.0
A08905,10,8,0,18,0.56,0.44,0.0
A08906,1,5,0,6,0.17,0.83,0.0
A08907,12,7,0,19,0.63,0.37,0.0
A08908,0,4,0,4,0.0,1.0,0.0
A08909,0,3,0,3,0.0,1.0,0.0
A08910,0,2,0,2,0.0,1.0,0.0
A08911,2,5,0,7,0.29,0.71,0.0
A08912,1,1,0,2,0.5,0.5,0.0
A08913,0,2,0,2,0.0,1.0,0.0
A08914,3,9,0,12,0.25,0.75,0.0
A08915,12,9,0,21,0.57,0.43,0.0
A08916,1,2,0,3,0.33,0.67,0.0
A08917,2,1,0,3,0.67,0.33,0.0
A08918,0,7,0,7,0.0,1.0,0.0
A08919,43,159,3,205,0.21,0.78,0.01
A08920,8,9,0,17,0.47,0.53,0.0
A08921,3,6,0,9,0.33,0.67,0.0
A08922,2,3,0,5,0.4,0.6,0.0
A08923,1,1,0,2,0.5,0.5,0.0
A08924,2,6,0,8,0.25,0.75,0.0
A08925,9,16,0,25,0.36,0.64,0.0
A08927,4,4,0,8,0.5,0.5,0.0
A08928,6,2,0,8,0.75,0.25,0.0
A08929,9,5,0,14,0.64,0.36,0.0
A08930,0,2,0,2,0.0,1.0,0.0
A08931,0,1,0,1,0.0,1.0,0.0
A08932,5,7,0,12,0.42,0.58,0.0
A08933,13,44,0,57,0.23,0.77,0.0
A08934,1,4,0,5,0.2,0.8,0.0
A08935,3,5,0,8,0.38,0.62,0.0
A08936,4,12,0,16,0.25,0.75,0.0
A08937,4,12,0,16,0.25,0.75,0.0
A08938,5,8,0,13,0.38,0.62,0.0
A08939,3,6,0,9,0.33,0.67,0.0
A08940,0,4,0,4,0.0,1.0,0.0
A08942,0,3,0,3,0.0,1.0,0.0
A08943,3,3,0,6,0.5,0.5,0.0
A08944,2,5,0,7,0.29,0.71,0.0
A08945,7,10,0,17,0.41,0.59,0.0
A08946,6,0,0,6,1.0,0.0,0.0
A08947,11,3,0,14,0.79,0.21,0.0
A08949,11,6,0,17,0.65,0.35,0.0
A08950,2,0,0,2,1.0,0.0,0.0
A08951,30,14,0,44,0.68,0.32,0.0
A08952,1,0,0,1,1.0,0.0,0.0
A08953,1,1,0,2,0.5,0.5,0.0
A08955,6,8,0,14,0.43,0.57,0.0
A08956,7,6,0,13,0.54,0.46,0.0
A08957,1,1,0,2,0.5,0.5,0.0
A08959,2,5,0,7,0.29,0.71,0.0
A08961,1,5,0,6,0.17,0.83,0.0
A08962,1,1,0,2,0.5,0.5,0.0
A08963,2,1,0,3,0.67,0.33,0.0
A08966,1,2,0,3,0.33,0.67,0.0
A08967,6,3,0,9,0.67,0.33,0.0
A08968,0,1,0,1,0.0,1.0,0.0
A08969,3,3,0,6,0.5,0.5,0.0
A08970,0,1,0,1,0.0,1.0,0.0
A08971,9,22,0,31,0.29,0.71,0.0
A08972,3,9,0,12,0.25,0.75,0.0
A08973,5,18,0,23,0.22,0.78,0.0
A08974,1,5,0,6,0.17,0.83,0.0
A08975,1,3,0,4,0.25,0.75,0.0
A08976,1,2,0,3,0.33,0.67,0.0
A08977,5,3,0,8,0.62,0.38,0.0
A08978,0,6,0,6,0.0,1.0,0.0
A08979,0,1,0,1,0.0,1.0,0.0
A08980,11,9,0,20,0.55,0.45,0.0
A08981,10,4,0,14,0.71,0.29,0.0
A08982,5,4,0,9,0.56,0.44,0.0
A08984,0,1,0,1,0.0,1.0,0.0
A08985,3,0,0,3,1.0,0.0,0.0
A08986,4,11,0,15,0.27,0.73,0.0
A08987,0,1,0,1,0.0,1.0,0.0
A08988,6,7,0,13,0.46,0.54,0.0
A08989,4,8,0,12,0.33,0.67,0.0
A08990,7,6,0,13,0.54,0.46,0.0
A08991,0,3,0,3,0.0,1.0,0.0
A08992,1,0,0,1,1.0,0.0,0.0
A08994,1,1,0,2,0.5,0.5,0.0
A08995,3,2,0,5,0.6,0.4,0.0
A08996,0,4,0,4,0.0,1.0,0.0
A08997,2,3,0,5,0.4,0.6,0.0
A08998,1,4,0,5,0.2,0.8,0.0
A08999,15,4,0,19,0.79,0.21,0.0
A09000,10,5,0,15,0.67,0.33,0.0
A09001,1,0,0,1,1.0,0.0,0.0
A09002,4,4,0,8,0.5,0.5,0.0
A09003,17,9,0,26,0.65,0.35,0.0
A09004,5,4,0,9,0.56,0.44,0.0
A09005,3,10,0,13,0.23,0.77,0.0
A09006,24,12,0,36,0.67,0.33,0.0
A09007,1,2,0,3,0.33,0.67,0.0
A09008,12,0,0,12,1.0,0.0,0.0
A09009,2,3,0,5,0.4,0.6,0.0
A09010,8,5,0,13,0.62,0.38,0.0
A09011,2,1,0,3,0.67,0.33,0.0
A09013,11,6,0,17,0.65,0.35,0.0
A09014,0,2,0,2,0.0,1.0,0.0
A09015,4,8,0,12,0.33,0.67,0.0
A09016,4,10,0,14,0.29,0.71,0.0
A09017,10,2,0,12,0.83,0.17,0.0
A09018,22,16,0,38,0.58,0.42,0.0
A09019,65,20,1,86,0.76,0.23,0.01
A09020,0,2,0,2,0.0,1.0,0.0
A09021,3,1,0,4,0.75,0.25,0.0
A09022,10,3,0,13,0.77,0.23,0.0
A09023,5,12,0,17,0.29,0.71,0.0
A09024,0,4,0,4,0.0,1.0,0.0
A09025,0,3,0,3,0.0,1.0,0.0
A09027,2,4,0,6,0.33,0.67,0.0
A09028,0,3,0,3,0.0,1.0,0.0
A09029,3,6,0,9,0.33,0.67,0.0
A09030,0,3,0,3,0.0,1.0,0.0
A09031,12,9,0,21,0.57,0.43,0.0
A09032,5,3,0,8,0.62,0.38,0.0
A09033,0,3,0,3,0.0,1.0,0.0
A09034,1,2,0,3,0.33,0.67,0.0
A09035,7,9,0,16,0.44,0.56,0.0
A09036,1,4,0,5,0.2,0.8,0.0
A09037,9,7,0,16,0.56,0.44,0.0
A09038,22,12,0,34,0.65,0.35,0.0
A09039,63,19,0,82,0.77,0.23,0.0
A09040,5,3,0,8,0.62,0.38,0.0
A09042,26,32,0,58,0.45,0.55,0.0
A09043,2,6,0,8,0.25,0.75,0.0
A09044,7,5,0,12,0.58,0.42,0.0
A09045,2,3,0,5,0.4,0.6,0.0
A09046,96,63,4,163,0.59,0.39,0.02
A09047,2,2,0,4,0.5,0.5,0.0
A09048,11,11,0,22,0.5,0.5,0.0
A09049,22,25,0,47,0.47,0.53,0.0
A09050,1,1,0,2,0.5,0.5,0.0
A09051,9,10,0,19,0.47,0.53,0.0
A09052,7,5,0,12,0.58,0.42,0.0
A09053,7,8,0,15,0.47,0.53,0.0
A09054,4,11,0,15,0.27,0.73,0.0
A09055,2,2,0,4,0.5,0.5,0.0
A09056,16,9,0,25,0.64,0.36,0.0
A09057,5,3,0,8,0.62,0.38,0.0
A09058,7,6,2,15,0.47,0.4,0.13
A09059,0,1,0,1,0.0,1.0,0.0
A09060,10,3,0,13,0.77,0.23,0.0
A09061,12,4,0,16,0.75,0.25,0.0
A09062,3,6,0,9,0.33,0.67,0.0
A09064,2,4,0,6,0.33,0.67,0.0
A09065,1,2,0,3,0.33,0.67,0.0
A09066,17,6,0,23,0.74,0.26,0.0
A09067,7,5,0,12,0.58,0.42,0.0
A09068,1,6,0,7,0.14,0.86,0.0
A09069,2,5,0,7,0.29,0.71,0.0
A09070,13,8,0,21,0.62,0.38,0.0
A09071,14,9,0,23,0.61,0.39,0.0
A09072,38,15,0,53,0.72,0.28,0.0
A09073,18,18,0,36,0.5,0.5,0.0
A09074,3,5,0,8,0.38,0.62,0.0
A09075,30,20,0,50,0.6,0.4,0.0
A09076,9,4,0,13,0.69,0.31,0.0
A09077,2,5,0,7,0.29,0.71,0.0
A09078,4,3,0,7,0.57,0.43,0.0
A09079,8,16,0,24,0.33,0.67,0.0
A09080,1,1,0,2,0.5,0.5,0.0
A09081,6,7,0,13,0.46,0.54,0.0
A09082,18,8,0,26,0.69,0.31,0.0
A09083,12,24,1,37,0.32,0.65,0.03
A09084,11,5,0,16,0.69,0.31,0.0
A09085,7,6,0,13,0.54,0.46,0.0
A09086,0,1,0,1,0.0,1.0,0.0
A09087,3,3,0,6,0.5,0.5,0.0
A09088,10,7,0,17,0.59,0.41,0.0
A09089,8,17,0,25,0.32,0.68,0.0
A09090,3,5,0,8,0.38,0.62,0.0
A09091,1,4,0,5,0.2,0.8,0.0
A09092,128,21,0,149,0.86,0.14,0.0
A09093,2,1,0,3,0.67,0.33,0.0
A09094,10,19,0,29,0.34,0.66,0.0
A09095,1,6,0,7,0.14,0.86,0.0
A09096,7,6,0,13,0.54,0.46,0.0
A09097,1,0,0,1,1.0,0.0,0.0
A09098,3,3,0,6,0.5,0.5,0.0
A09099,4,0,0,4,1.0,0.0,0.0
A09100,1,8,0,9,0.11,0.89,0.0
A09101,1,2,0,3,0.33,0.67,0.0
A09102,47,15,0,62,0.76,0.24,0.0
A09103,18,11,0,29,0.62,0.38,0.0
A09104,0,3,0,3,0.0,1.0,0.0
A09105,28,14,0,42,0.67,0.33,0.0
A09106,1,1,0,2,0.5,0.5,0.0
A09107,1,1,0,2,0.5,0.5,0.0
A09108,9,5,0,14,0.64,0.36,0.0
A09109,0,1,0,1,0.0,1.0,0.0
A09110,9,7,0,16,0.56,0.44,0.0
A09111,0,2,0,2,0.0,1.0,0.0
A09112,11,16,0,27,0.41,0.59,0.0
A09113,1,1,0,2,0.5,0.5,0.0
A09114,9,10,0,19,0.47,0.53,0.0
A09115,9,6,0,15,0.6,0.4,0.0
A09116,16,7,0,23,0.7,0.3,0.0
A09117,0,5,0,5,0.0,1.0,0.0
A09119,0,1,0,1,0.0,1.0,0.0
A09121,0,1,0,1,0.0,1.0,0.0
A09122,8,9,0,17,0.47,0.53,0.0
A09123,8,9,0,17,0.47,0.53,0.0
A09124,5,11,0,16,0.31,0.69,0.0
A09125,12,8,0,20,0.6,0.4,0.0
A09126,3,1,0,4,0.75,0.25,0.0
A09127,2,2,0,4,0.5,0.5,0.0
A09128,11,6,0,17,0.65,0.35,0.0
A09129,3,4,0,7,0.43,0.57,0.0
A09130,3,3,0,6,0.5,0.5,0.0
A09131,3,3,0,6,0.5,0.5,0.0
A09132,0,8,0,8,0.0,1.0,0.0
A09133,8,7,0,15,0.53,0.47,0.0
A09134,12,4,0,16,0.75,0.25,0.0
A09135,5,22,0,27,0.19,0.81,0.0
A09136,1,1,0,2,0.5,0.5,0.0
A09138,4,8,0,12,0.33,0.67,0.0
A09140,1,3,0,4,0.25,0.75,0.0
A09141,0,8,0,8,0.0,1.0,0.0
A09142,3,2,0,5,0.6,0.4,0.0
A09143,4,4,0,8,0.5,0.5,0.0
A09145,0,2,0,2,0.0,1.0,0.0
A09146,2,4,0,6,0.33,0.67,0.0
A09147,2,3,0,5,0.4,0.6,0.0
A09149,30,8,0,38,0.79,0.21,0.0
A09150,8,13,0,21,0.38,0.62,0.0
A09151,6,6,1,13,0.46,0.46,0.08
A09152,1,4,0,5,0.2,0.8,0.0
A09153,6,6,0,12,0.5,0.5,0.0
A09154,0,6,0,6,0.0,1.0,0.0
A09155,18,13,0,31,0.58,0.42,0.0
A09156,1,3,0,4,0.25,0.75,0.0
A09157,7,11,0,18,0.39,0.61,0.0
A09158,7,14,0,21,0.33,0.67,0.0
A09159,6,5,0,11,0.55,0.45,0.0
A09160,1,1,0,2,0.5,0.5,0.0
A09161,3,6,0,9,0.33,0.67,0.0
A09162,0,3,0,3,0.0,1.0,0.0
A09163,4,5,0,9,0.44,0.56,0.0
A09164,2,6,0,8,0.25,0.75,0.0
A09165,0,3,0,3,0.0,1.0,0.0
A09166,2,6,0,8,0.25,0.75,0.0
A09167,4,2,0,6,0.67,0.33,0.0
A09168,1,1,0,2,0.5,0.5,0.0
A09169,27,24,1,52,0.52,0.46,0.02
A09170,4,10,0,14,0.29,0.71,0.0
A09171,2,2,0,4,0.5,0.5,0.0
A09172,4,8,0,12,0.33,0.67,0.0
A09174,1,4,0,5,0.2,0.8,0.0
A09175,0,3,0,3,0.0,1.0,0.0
A09176,3,4,0,7,0.43,0.57,0.0
A09177,0,5,0,5,0.0,1.0,0.0
A09178,0,2,0,2,0.0,1.0,0.0
A09179,1,1,0,2,0.5,0.5,0.0
A09180,2,6,0,8,0.25,0.75,0.0
A09181,2,6,0,8,0.25,0.75,0.0
A09182,1,3,0,4,0.25,0.75,0.0
A09183,0,3,0,3,0.0,1.0,0.0
A09184,5,3,0,8,0.62,0.38,0.0
A09185,6,7,0,13,0.46,0.54,0.0
A09187,0,3,0,3,0.0,1.0,0.0
A09188,5,8,0,13,0.38,0.62,0.0
A09190,15,3,0,18,0.83,0.17,0.0
A09191,5,18,0,23,0.22,0.78,0.0
A09192,2,3,0,5,0.4,0.6,0.0
A09193,7,11,0,18,0.39,0.61,0.0
A09194,21,16,0,37,0.57,0.43,0.0
A09195,9,6,0,15,0.6,0.4,0.0
A09196,9,21,0,30,0.3,0.7,0.0
A09198,0,1,0,1,0.0,1.0,0.0
A09199,11,1,0,12,0.92,0.08,0.0
A09200,4,3,0,7,0.57,0.43,0.0
A09201,11,4,0,15,0.73,0.27,0.0
A09202,0,1,0,1,0.0,1.0,0.0
A09203,5,13,0,18,0.28,0.72,0.0
A09204,0,1,0,1,0.0,1.0,0.0
A09205,0,4,0,4,0.0,1.0,0.0
A09206,1,3,0,4,0.25,0.75,0.0
A09207,1,3,0,4,0.25,0.75,0.0
A09208,7,8,0,15,0.47,0.53,0.0
A09210,0,3,0,3,0.0,1.0,0.0
A09211,0,3,0,3,0.0,1.0,0.0
A09212,2,4,0,6,0.33,0.67,0.0
A09213,7,1,0,8,0.88,0.12,0.0
A09214,3,3,0,6,0.5,0.5,0.0
A09215,8,9,0,17,0.47,0.53,0.0
A09218,4,2,0,6,0.67,0.33,0.0
A09219,1,3,0,4,0.25,0.75,0.0
A09220,0,3,0,3,0.0,1.0,0.0
A09221,4,36,0,40,0.1,0.9,0.0
A09222,13,15,0,28,0.46,0.54,0.0
A09223,14,17,0,31,0.45,0.55,0.0
A09225,10,18,0,28,0.36,0.64,0.0
A09226,9,4,0,13,0.69,0.31,0.0
A09227,2,13,0,15,0.13,0.87,0.0
A09228,3,3,0,6,0.5,0.5,0.0
A09229,1,5,0,6,0.17,0.83,0.0
A09230,15,18,0,33,0.45,0.55,0.0
A09231,5,0,0,5,1.0,0.0,0.0
A09232,0,4,0,4,0.0,1.0,0.0
A09233,2,1,0,3,0.67,0.33,0.0
A09237,2,4,0,6,0.33,0.67,0.0
A09238,1,0,0,1,1.0,0.0,0.0
A09239,11,8,0,19,0.58,0.42,0.0
A09240,1,4,0,5,0.2,0.8,0.0
A09241,0,1,0,1,0.0,1.0,0.0
A09242,12,9,0,21,0.57,0.43,0.0
A09243,196,68,0,264,0.74,0.26,0.0
A09244,23,20,0,43,0.53,0.47,0.0
A09245,0,1,0,1,0.0,1.0,0.0
A09246,6,17,0,23,0.26,0.74,0.0
A09247,3,4,0,7,0.43,0.57,0.0
A09248,5,0,0,5,1.0,0.0,0.0
A09250,10,2,0,12,0.83,0.17,0.0
A09251,0,3,0,3,0.0,1.0,0.0
A09252,83,21,0,104,0.8,0.2,0.0
A09254,1,3,0,4,0.25,0.75,0.0
A09256,8,11,0,19,0.42,0.58,0.0
A09257,1,2,0,3,0.33,0.67,0.0
A09259,14,9,0,23,0.61,0.39,0.0
A09260,4,3,0,7,0.57,0.43,0.0
A09261,12,15,0,27,0.44,0.56,0.0
A09262,9,9,0,18,0.5,0.5,0.0
A09263,30,29,0,59,0.51,0.49,0.0
A09264,4,5,0,9,0.44,0.56,0.0
A09265,2,1,0,3,0.67,0.33,0.0
A09266,1,1,0,2,0.5,0.5,0.0
A09267,2,4,0,6,0.33,0.67,0.0
A09268,2,1,0,3,0.67,0.33,0.0
A09269,2,5,0,7,0.29,0.71,0.0
A09270,2,1,0,3,0.67,0.33,0.0
A09271,5,8,0,13,0.38,0.62,0.0
A09272,5,3,0,8,0.62,0.38,0.0
A09273,1,6,0,7,0.14,0.86,0.0
A09275,13,4,0,17,0.76,0.24,0.0
A09276,24,25,0,49,0.49,0.51,0.0
A09277,17,21,0,38,0.45,0.55,0.0
A09278,77,83,0,160,0.48,0.52,0.0
A09279,10,10,0,20,0.5,0.5,0.0
A09280,54,12,0,66,0.82,0.18,0.0
A09281,33,13,2,48,0.69,0.27,0.04
A09282,8,6,0,14,0.57,0.43,0.0
A09283,9,3,0,12,0.75,0.25,0.0
A09284,1,3,0,4,0.25,0.75,0.0
A09285,12,1,0,13,0.92,0.08,0.0
A09286,3,11,0,14,0.21,0.79,0.0
A09287,13,14,0,27,0.48,0.52,0.0
A09288,1,3,0,4,0.25,0.75,0.0
A09289,19,4,1,24,0.79,0.17,0.04
A09290,15,8,0,23,0.65,0.35,0.0
A09291,2,2,0,4,0.5,0.5,0.0
A09292,1,2,0,3,0.33,0.67,0.0
A09293,5,2,0,7,0.71,0.29,0.0
A09294,5,12,0,17,0.29,0.71,0.0
A09295,0,5,0,5,0.0,1.0,0.0
A09296,8,12,0,20,0.4,0.6,0.0
A09297,2,3,0,5,0.4,0.6,0.0
A09298,5,18,0,23,0.22,0.78,0.0
A09299,4,9,0,13,0.31,0.69,0.0
A09300,1,1,0,2,0.5,0.5,0.0
A09301,41,9,12,62,0.66,0.15,0.19
A09302,4,4,0,8,0.5,0.5,0.0
A09303,6,5,2,13,0.46,0.38,0.15
A09304,30,11,0,41,0.73,0.27,0.0
A09305,1,5,0,6,0.17,0.83,0.0
A09306,11,9,0,20,0.55,0.45,0.0
A09307,2,3,0,5,0.4,0.6,0.0
A09308,4,3,0,7,0.57,0.43,0.0
A09309,13,38,0,51,0.25,0.75,0.0
A09310,2,3,0,5,0.4,0.6,0.0
A09311,2,2,0,4,0.5,0.5,0.0
A09312,16,5,0,21,0.76,0.24,0.0
A09313,0,4,0,4,0.0,1.0,0.0
A09314,0,4,0,4,0.0,1.0,0.0
A09316,5,15,0,20,0.25,0.75,0.0
A09317,0,5,0,5,0.0,1.0,0.0
A09318,9,9,0,18,0.5,0.5,0.0
A09319,1,0,0,1,1.0,0.0,0.0
A09320,24,52,1,77,0.31,0.68,0.01
A09322,5,11,0,16,0.31,0.69,0.0
A09323,16,15,0,31,0.52,0.48,0.0
A09324,3,4,0,7,0.43,0.57,0.0
A09325,2,2,0,4,0.5,0.5,0.0
A09326,1,3,0,4,0.25,0.75,0.0
A09327,3,3,0,6,0.5,0.5,0.0
A09328,1,3,0,4,0.25,0.75,0.0
A09330,4,8,0,12,0.33,0.67,0.0
A09331,1,6,0,7,0.14,0.86,0.0
A09332,17,14,0,31,0.55,0.45,0.0
A09333,6,7,0,13,0.46,0.54,0.0
A09334,0,1,0,1,0.0,1.0,0.0
A09335,15,9,0,24,0.62,0.38,0.0
A09337,2,3,0,5,0.4,0.6,0.0
A09338,6,8,0,14,0.43,0.57,0.0
A09339,13,6,0,19,0.68,0.32,0.0
A09341,20,5,0,25,0.8,0.2,0.0
A09342,14,15,0,29,0.48,0.52,0.0
A09344,0,1,0,1,0.0,1.0,0.0
A09345,28,40,0,68,0.41,0.59,0.0
A09346,0,2,0,2,0.0,1.0,0.0
A09348,9,10,0,19,0.47,0.53,0.0
A09349,13,23,0,36,0.36,0.64,0.0
A09350,10,8,0,18,0.56,0.44,0.0
A09351,9,21,2,32,0.28,0.66,0.06
A09353,1,2,0,3,0.33,0.67,0.0
A09354,1,2,0,3,0.33,0.67,0.0
A09355,12,8,0,20,0.6,0.4,0.0
A09356,0,1,0,1,0.0,1.0,0.0
A09357,5,11,0,16,0.31,0.69,0.0
A09358,7,12,0,19,0.37,0.63,0.0
A09359,1,1,0,2,0.5,0.5,0.0
A09360,4,3,0,7,0.57,0.43,0.0
A09362,10,4,0,14,0.71,0.29,0.0
A09364,8,4,0,12,0.67,0.33,0.0
A09365,0,5,0,5,0.0,1.0,0.0
A09366,58,20,0,78,0.74,0.26,0.0
A09367,13,8,0,21,0.62,0.38,0.0
A09368,19,12,0,31,0.61,0.39,0.0
A09369,0,6,0,6,0.0,1.0,0.0
A09370,0,3,0,3,0.0,1.0,0.0
A09371,2,7,0,9,0.22,0.78,0.0
A09372,7,8,0,15,0.47,0.53,0.0
A09373,6,6,0,12,0.5,0.5,0.0
A09374,3,6,0,9,0.33,0.67,0.0
A09375,0,3,0,3,0.0,1.0,0.0
A09376,1,1,0,2,0.5,0.5,0.0
A09377,4,2,0,6,0.67,0.33,0.0
A09378,4,5,0,9,0.44,0.56,0.0
A09379,13,15,0,28,0.46,0.54,0.0
A09380,9,7,0,16,0.56,0.44,0.0
A09381,9,5,0,14,0.64,0.36,0.0
A09382,7,9,0,16,0.44,0.56,0.0
A09383,7,7,0,14,0.5,0.5,0.0
A09385,4,6,0,10,0.4,0.6,0.0
A09386,0,1,0,1,0.0,1.0,0.0
A09387,0,5,0,5,0.0,1.0,0.0
A09389,21,13,0,34,0.62,0.38,0.0
A09390,0,6,0,6,0.0,1.0,0.0
A09392,1,1,0,2,0.5,0.5,0.0
A09393,0,4,0,4,0.0,1.0,0.0
A09394,19,16,0,35,0.54,0.46,0.0
A09395,8,9,0,17,0.47,0.53,0.0
A09396,0,1,0,1,0.0,1.0,0.0
A09398,5,3,0,8,0.62,0.38,0.0
A09399,0,1,0,1,0.0,1.0,0.0
A09400,19,28,0,47,0.4,0.6,0.0
A09401,7,2,0,9,0.78,0.22,0.0
A09402,13,11,0,24,0.54,0.46,0.0
A09403,0,1,0,1,0.0,1.0,0.0
A09404,13,11,0,24,0.54,0.46,0.0
A09405,6,10,0,16,0.38,0.62,0.0
A09406,4,19,0,23,0.17,0.83,0.0
A09407,39,18,0,57,0.68,0.32,0.0
A09408,3,7,0,10,0.3,0.7,0.0
A09409,0,4,0,4,0.0,1.0,0.0
A09410,4,3,0,7,0.57,0.43,0.0
A09411,5,9,0,14,0.36,0.64,0.0
A09413,2,4,0,6,0.33,0.67,0.0
A09414,11,19,0,30,0.37,0.63,0.0
A09415,1,3,0,4,0.25,0.75,0.0
A09416,1,2,0,3,0.33,0.67,0.0
A09417,3,4,0,7,0.43,0.57,0.0
A09418,0,2,0,2,0.0,1.0,0.0
A09419,4,8,0,12,0.33,0.67,0.0
A09421,3,3,0,6,0.5,0.5,0.0
A09423,2,11,0,13,0.15,0.85,0.0
A09424,3,11,0,14,0.21,0.79,0.0
A09425,14,9,0,23,0.61,0.39,0.0
A09426,4,16,0,20,0.2,0.8,0.0
A09427,5,3,0,8,0.62,0.38,0.0
A09428,1,5,0,6,0.17,0.83,0.0
A09429,8,12,0,20,0.4,0.6,0.0
A09430,10,9,0,19,0.53,0.47,0.0
A09431,13,20,0,33,0.39,0.61,0.0
A09432,2,0,0,2,1.0,0.0,0.0
A09433,1,2,0,3,0.33,0.67,0.0
A09434,1,5,0,6,0.17,0.83,0.0
A09435,10,5,0,15,0.67,0.33,0.0
A09436,8,14,0,22,0.36,0.64,0.0
A09437,9,10,0,19,0.47,0.53,0.0
A09438,2,4,0,6,0.33,0.67,0.0
A09439,5,4,0,9,0.56,0.44,0.0
A09440,1,1,0,2,0.5,0.5,0.0
A09441,15,3,0,18,0.83,0.17,0.0
A09442,4,3,0,7,0.57,0.43,0.0
A09443,8,12,0,20,0.4,0.6,0.0
A09444,5,9,0,14,0.36,0.64,0.0
A09445,2,6,0,8,0.25,0.75,0.0
A09446,2,6,0,8,0.25,0.75,0.0
A09448,3,0,0,3,1.0,0.0,0.0
A09449,8,6,0,14,0.57,0.43,0.0
A09450,3,2,0,5,0.6,0.4,0.0
A09451,19,17,0,36,0.53,0.47,0.0
A09452,4,9,0,13,0.31,0.69,0.0
A09454,1,2,0,3,0.33,0.67,0.0
A09455,3,0,0,3,1.0,0.0,0.0
A09456,1,1,0,2,0.5,0.5,0.0
A09457,12,4,0,16,0.75,0.25,0.0
A09458,4,2,0,6,0.67,0.33,0.0
A09459,10,4,0,14,0.71,0.29,0.0
A09460,1,3,0,4,0.25,0.75,0.0
A09461,8,15,0,23,0.35,0.65,0.0
A09462,7,5,0,12,0.58,0.42,0.0
A09463,0,5,0,5,0.0,1.0,0.0
A09464,4,2,0,6,0.67,0.33,0.0
A09465,0,1,0,1,0.0,1.0,0.0
A09466,1,7,0,8,0.12,0.88,0.0
A09467,3,6,0,9,0.33,0.67,0.0
A09468,3,4,0,7,0.43,0.57,0.0
A09469,32,15,0,47,0.68,0.32,0.0
A09470,5,9,0,14,0.36,0.64,0.0
A09471,6,9,0,15,0.4,0.6,0.0
A09472,13,13,0,26,0.5,0.5,0.0
A09473,1,2,0,3,0.33,0.67,0.0
A09474,21,9,0,30,0.7,0.3,0.0
A09475,0,2,0,2,0.0,1.0,0.0
A09476,1,6,0,7,0.14,0.86,0.0
A09477,11,4,0,15,0.73,0.27,0.0
A09478,2,2,0,4,0.5,0.5,0.0
A09479,0,2,0,2,0.0,1.0,0.0
A09480,2,5,0,7,0.29,0.71,0.0
A09481,27,2,0,29,0.93,0.07,0.0
A09483,0,1,0,1,0.0,1.0,0.0
A09484,4,8,0,12,0.33,0.67,0.0
A09485,8,9,0,17,0.47,0.53,0.0
A09486,17,21,0,38,0.45,0.55,0.0
A09487,0,1,0,1,0.0,1.0,0.0
A09488,4,3,0,7,0.57,0.43,0.0
A09489,1,2,0,3,0.33,0.67,0.0
A09490,4,1,0,5,0.8,0.2,0.0
A09491,12,18,0,30,0.4,0.6,0.0
A09492,2,2,0,4,0.5,0.5,0.0
A09493,27,12,0,39,0.69,0.31,0.0
A09494,5,8,0,13,0.38,0.62,0.0
A09495,2,4,0,6,0.33,0.67,0.0
A09496,46,83,0,129,0.36,0.64,0.0
A09497,0,3,0,3,0.0,1.0,0.0
A09498,2,6,0,8,0.25,0.75,0.0
A09499,22,10,0,32,0.69,0.31,0.0
A09500,3,10,0,13,0.23,0.77,0.0
A09501,0,1,0,1,0.0,1.0,0.0
A09502,1,3,0,4,0.25,0.75,0.0
A09503,0,1,0,1,0.0,1.0,0.0
A09504,134,91,5,230,0.58,0.4,0.02
A09505,1,0,0,1,1.0,0.0,0.0
A09506,2,2,0,4,0.5,0.5,0.0
A09508,2,2,0,4,0.5,0.5,0.0
A09509,11,13,0,24,0.46,0.54,0.0
A09510,5,7,0,12,0.42,0.58,0.0
A09511,4,5,0,9,0.44,0.56,0.0
A09512,4,4,0,8,0.5,0.5,0.0
A09513,14,18,0,32,0.44,0.56,0.0
A09514,5,2,0,7,0.71,0.29,0.0
A09516,1,2,0,3,0.33,0.67,0.0
A09517,0,2,0,2,0.0,1.0,0.0
A09518,1,3,0,4,0.25,0.75,0.0
A09519,2,0,0,2,1.0,0.0,0.0
A09520,20,26,0,46,0.43,0.57,0.0
A09522,2,5,0,7,0.29,0.71,0.0
A09523,3,4,0,7,0.43,0.57,0.0
A09524,1,0,0,1,1.0,0.0,0.0
A09525,1,3,0,4,0.25,0.75,0.0
A09526,1,1,0,2,0.5,0.5,0.0
A09528,8,10,0,18,0.44,0.56,0.0
A09529,1,3,0,4,0.25,0.75,0.0
A09530,1,3,0,4,0.25,0.75,0.0
A09531,0,2,0,2,0.0,1.0,0.0
A09532,0,3,0,3,0.0,1.0,0.0
A09533,4,5,0,9,0.44,0.56,0.0
A09534,0,4,0,4,0.0,1.0,0.0
A09535,7,8,0,15,0.47,0.53,0.0
A09536,23,18,0,41,0.56,0.44,0.0
A09537,0,1,0,1,0.0,1.0,0.0
A09538,5,3,0,8,0.62,0.38,0.0
A09539,3,1,0,4,0.75,0.25,0.0
A09540,3,3,0,6,0.5,0.5,0.0
A09541,0,1,0,1,0.0,1.0,0.0
A09542,15,11,0,26,0.58,0.42,0.0
A09543,9,9,0,18,0.5,0.5,0.0
A09544,2,5,0,7,0.29,0.71,0.0
A09545,3,2,0,5,0.6,0.4,0.0
A09546,11,7,0,18,0.61,0.39,0.0
A09547,19,21,0,40,0.47,0.53,0.0
A09548,62,16,0,78,0.79,0.21,0.0
A09549,0,2,0,2,0.0,1.0,0.0
A09550,5,3,0,8,0.62,0.38,0.0
A09551,24,12,0,36,0.67,0.33,0.0
A09552,7,5,0,12,0.58,0.42,0.0
A09553,1,4,0,5,0.2,0.8,0.0
A09554,13,4,0,17,0.76,0.24,0.0
A09555,25,10,0,35,0.71,0.29,0.0
A09556,15,3,0,18,0.83,0.17,0.0
A09557,1,3,0,4,0.25,0.75,0.0
A09558,2,2,0,4,0.5,0.5,0.0
A09559,23,4,0,27,0.85,0.15,0.0
A09560,45,3,0,48,0.94,0.06,0.0
A09561,8,7,0,15,0.53,0.47,0.0
A09562,1,6,0,7,0.14,0.86,0.0
A09563,164,15,0,179,0.92,0.08,0.0
A09564,0,2,0,2,0.0,1.0,0.0
A09565,14,9,0,23,0.61,0.39,0.0
A09566,1,2,0,3,0.33,0.67,0.0
A09567,2,5,0,7,0.29,0.71,0.0
A09568,4,4,0,8,0.5,0.5,0.0
A09570,13,25,0,38,0.34,0.66,0.0
A09571,24,13,0,37,0.65,0.35,0.0
A09572,1,0,0,1,1.0,0.0,0.0
A09573,3,3,0,6,0.5,0.5,0.0
A09574,4,5,0,9,0.44,0.56,0.0
A09575,9,6,0,15,0.6,0.4,0.0
A09576,16,16,0,32,0.5,0.5,0.0
A09577,1,5,0,6,0.17,0.83,0.0
A09578,0,1,0,1,0.0,1.0,0.0
A09579,6,10,0,16,0.38,0.62,0.0
A09580,6,12,0,18,0.33,0.67,0.0
A09581,0,1,0,1,0.0,1.0,0.0
A09582,1,3,0,4,0.25,0.75,0.0
A09583,0,1,0,1,0.0,1.0,0.0
A09584,7,1,0,8,0.88,0.12,0.0
A09585,1,1,0,2,0.5,0.5,0.0
A09587,0,1,0,1,0.0,1.0,0.0
A09588,25,15,0,40,0.62,0.38,0.0
A09589,2,6,0,8,0.25,0.75,0.0
A09590,10,10,0,20,0.5,0.5,0.0
A09591,24,14,0,38,0.63,0.37,0.0
A09592,0,3,0,3,0.0,1.0,0.0
A09593,8,5,0,13,0.62,0.38,0.0
A09594,5,1,0,6,0.83,0.17,0.0
A09595,12,7,0,19,0.63,0.37,0.0
A09596,4,2,0,6,0.67,0.33,0.0
A09597,19,3,0,22,0.86,0.14,0.0
A09598,0,2,0,2,0.0,1.0,0.0
A09599,8,7,0,15,0.53,0.47,0.0
A09600,0,1,0,1,0.0,1.0,0.0
A09602,5,9,0,14,0.36,0.64,0.0
A09603,2,5,0,7,0.29,0.71,0.0
A09604,64,58,4,126,0.51,0.46,0.03
A09605,31,12,0,43,0.72,0.28,0.0
A09606,14,28,0,42,0.33,0.67,0.0
A09607,0,1,0,1,0.0,1.0,0.0
A09608,14,21,0,35,0.4,0.6,0.0
A09609,1,5,0,6,0.17,0.83,0.0
A09610,2,0,0,2,1.0,0.0,0.0
A09611,3,4,0,7,0.43,0.57,0.0
A09612,4,5,0,9,0.44,0.56,0.0
A09613,4,5,0,9,0.44,0.56,0.0
A09614,4,2,0,6,0.67,0.33,0.0
A09615,0,1,0,1,0.0,1.0,0.0
A09617,4,10,0,14,0.29,0.71,0.0
A09618,0,6,0,6,0.0,1.0,0.0
A09619,2,4,0,6,0.33,0.67,0.0
A09620,2,5,0,7,0.29,0.71,0.0
A09621,3,1,0,4,0.75,0.25,0.0
A09622,17,7,0,24,0.71,0.29,0.0
A09623,5,14,0,19,0.26,0.74,0.0
A09624,1,1,0,2,0.5,0.5,0.0
A09625,2,3,0,5,0.4,0.6,0.0
A09626,0,2,0,2,0.0,1.0,0.0
A09627,76,73,0,149,0.51,0.49,0.0
A09628,4,1,0,5,0.8,0.2,0.0
A09629,1,5,0,6,0.17,0.83,0.0
A09630,14,14,0,28,0.5,0.5,0.0
A09631,9,14,0,23,0.39,0.61,0.0
A09632,1,5,0,6,0.17,0.83,0.0
A09633,26,9,0,35,0.74,0.26,0.0
A09634,3,2,0,5,0.6,0.4,0.0
A09635,0,1,0,1,0.0,1.0,0.0
A09636,97,86,0,183,0.53,0.47,0.0
A09637,43,15,0,58,0.74,0.26,0.0
A09638,1,3,0,4,0.25,0.75,0.0
A09639,14,41,0,55,0.25,0.75,0.0
A09640,7,5,0,12,0.58,0.42,0.0
A09641,2,4,0,6,0.33,0.67,0.0
A09642,1,5,0,6,0.17,0.83,0.0
A09643,9,6,0,15,0.6,0.4,0.0
A09644,21,27,0,48,0.44,0.56,0.0
A09645,2,6,0,8,0.25,0.75,0.0
A09646,1,3,0,4,0.25,0.75,0.0
A09648,3,6,0,9,0.33,0.67,0.0
A09649,1,2,0,3,0.33,0.67,0.0
A09650,0,3,0,3,0.0,1.0,0.0
A09651,3,12,0,15,0.2,0.8,0.0
A09652,5,15,0,20,0.25,0.75,0.0
A09653,2,2,0,4,0.5,0.5,0.0
A09654,12,17,0,29,0.41,0.59,0.0
A09655,0,1,0,1,0.0,1.0,0.0
A09656,14,4,0,18,0.78,0.22,0.0
A09660,2,1,0,3,0.67,0.33,0.0
A09661,14,9,0,23,0.61,0.39,0.0
A09662,9,4,0,13,0.69,0.31,0.0
A09663,2,6,0,8,0.25,0.75,0.0
A09664,1,7,0,8,0.12,0.88,0.0
A09665,12,20,0,32,0.38,0.62,0.0
A09666,1,5,0,6,0.17,0.83,0.0
A09668,4,2,0,6,0.67,0.33,0.0
A09669,0,1,0,1,0.0,1.0,0.0
A09670,9,9,0,18,0.5,0.5,0.0
A09671,4,4,0,8,0.5,0.5,0.0
A09672,3,3,0,6,0.5,0.5,0.0
A09673,1,5,0,6,0.17,0.83,0.0
A09674,2,2,0,4,0.5,0.5,0.0
A09675,1,1,0,2,0.5,0.5,0.0
A09676,5,4,0,9,0.56,0.44,0.0
A09678,0,2,0,2,0.0,1.0,0.0
A09679,2,5,0,7,0.29,0.71,0.0
A09680,29,37,1,67,0.43,0.55,0.01
A09681,1,5,0,6,0.17,0.83,0.0
A09682,26,23,7,56,0.46,0.41,0.12
A09683,10,4,0,14,0.71,0.29,0.0
A09684,6,7,0,13,0.46,0.54,0.0
A09685,0,1,0,1,0.0,1.0,0.0
A09686,0,4,0,4,0.0,1.0,0.0
A09687,2,3,0,5,0.4,0.6,0.0
A09688,0,1,0,1,0.0,1.0,0.0
A09689,2,11,0,13,0.15,0.85,0.0
A09690,8,7,0,15,0.53,0.47,0.0
A09691,6,8,0,14,0.43,0.57,0.0
A09692,18,15,0,33,0.55,0.45,0.0
A09693,1,4,0,5,0.2,0.8,0.0
A09695,2,4,0,6,0.33,0.67,0.0
A09696,1,8,0,9,0.11,0.89,0.0
A09697,0,5,0,5,0.0,1.0,0.0
A09698,0,1,0,1,0.0,1.0,0.0
A09700,74,22,0,96,0.77,0.23,0.0
A09701,5,8,1,14,0.36,0.57,0.07
A09702,11,6,0,17,0.65,0.35,0.0
A09704,7,8,0,15,0.47,0.53,0.0
A09706,13,9,0,22,0.59,0.41,0.0
A09707,3,2,0,5,0.6,0.4,0.0
A09708,0,3,0,3,0.0,1.0,0.0
A09709,2,4,0,6,0.33,0.67,0.0
A09710,10,13,0,23,0.43,0.57,0.0
A09711,51,14,0,65,0.78,0.22,0.0
A09712,11,4,0,15,0.73,0.27,0.0
A09713,19,26,0,45,0.42,0.58,0.0
A09714,3,5,0,8,0.38,0.62,0.0
A09715,5,11,0,16,0.31,0.69,0.0
A09716,3,6,0,9,0.33,0.67,0.0
A09717,1,3,0,4,0.25,0.75,0.0
A09718,9,7,0,16,0.56,0.44,0.0
A09719,2,2,0,4,0.5,0.5,0.0
A09720,0,5,0,5,0.0,1.0,0.0
A09721,1,4,0,5,0.2,0.8,0.0
A09722,0,1,0,1,0.0,1.0,0.0
A09723,0,0,1,1,0.0,0.0,1.0
A09724,3,4,0,7,0.43,0.57,0.0
A09725,11,4,0,15,0.73,0.27,0.0
A09726,24,24,0,48,0.5,0.5,0.0
A09727,72,31,0,103,0.7,0.3,0.0
A09728,12,16,0,28,0.43,0.57,0.0
A09729,4,2,0,6,0.67,0.33,0.0
A09730,2,0,0,2,1.0,0.0,0.0
A09731,21,11,0,32,0.66,0.34,0.0
A09732,9,7,0,16,0.56,0.44,0.0
A09733,0,1,0,1,0.0,1.0,0.0
A09734,1,2,0,3,0.33,0.67,0.0
A09735,6,6,0,12,0.5,0.5,0.0
A09736,2,1,0,3,0.67,0.33,0.0
A09737,0,3,0,3,0.0,1.0,0.0
A09738,24,9,0,33,0.73,0.27,0.0
A09739,0,5,0,5,0.0,1.0,0.0
A09740,1,3,0,4,0.25,0.75,0.0
A09741,0,4,0,4,0.0,1.0,0.0
A09743,2,7,0,9,0.22,0.78,0.0
A09744,4,3,0,7,0.57,0.43,0.0
A09745,19,21,0,40,0.47,0.53,0.0
A09746,3,2,0,5,0.6,0.4,0.0
A09747,0,2,0,2,0.0,1.0,0.0
A09748,28,9,0,37,0.76,0.24,0.0
A09749,27,39,0,66,0.41,0.59,0.0
A09750,23,2,0,25,0.92,0.08,0.0
A09751,6,11,0,17,0.35,0.65,0.0
A09752,0,1,0,1,0.0,1.0,0.0
A09753,6,11,0,17,0.35,0.65,0.0
A09754,0,1,0,1,0.0,1.0,0.0
A09755,2,0,0,2,1.0,0.0,0.0
A09757,2,1,0,3,0.67,0.33,0.0
A09758,6,9,0,15,0.4,0.6,0.0
A09759,1,7,0,8,0.12,0.88,0.0
A09761,6,3,0,9,0.67,0.33,0.0
A09762,3,3,0,6,0.5,0.5,0.0
A09763,0,5,0,5,0.0,1.0,0.0
A09764,5,3,0,8,0.62,0.38,0.0
A09765,11,12,0,23,0.48,0.52,0.0
A09766,0,4,0,4,0.0,1.0,0.0
A09773,0,2,0,2,0.0,1.0,0.0
A09774,4,2,0,6,0.67,0.33,0.0
A09775,5,0,0,5,1.0,0.0,0.0
A09777,13,10,0,23,0.57,0.43,0.0
A09778,8,4,0,12,0.67,0.33,0.0
A09779,7,10,0,17,0.41,0.59,0.0
A09780,13,11,0,24,0.54,0.46,0.0
A09781,1,6,0,7,0.14,0.86,0.0
A09783,24,27,1,52,0.46,0.52,0.02
A09784,6,14,0,20,0.3,0.7,0.0
A09785,4,8,0,12,0.33,0.67,0.0
A09786,1,6,0,7,0.14,0.86,0.0
A09787,6,8,0,14,0.43,0.57,0.0
A09788,2,4,0,6,0.33,0.67,0.0
A09789,0,1,0,1,0.0,1.0,0.0
A09790,1,1,0,2,0.5,0.5,0.0
A09791,3,6,0,9,0.33,0.67,0.0
A09792,1,3,0,4,0.25,0.75,0.0
A09793,20,8,0,28,0.71,0.29,0.0
A09794,0,1,0,1,0.0,1.0,0.0
A09795,9,10,0,19,0.47,0.53,0.0
A09796,86,21,0,107,0.8,0.2,0.0
A09797,2,2,0,4,0.5,0.5,0.0
A09798,8,0,6,14,0.57,0.0,0.43
A09799,3,4,0,7,0.43,0.57,0.0
A09800,2,10,0,12,0.17,0.83,0.0
A09801,15,22,0,37,0.41,0.59,0.0
A09802,2,7,0,9,0.22,0.78,0.0
A09803,1,7,0,8,0.12,0.88,0.0
A09804,3,11,0,14,0.21,0.79,0.0
A09805,2,1,0,3,0.67,0.33,0.0
A09806,2,7,0,9,0.22,0.78,0.0
A09807,4,3,0,7,0.57,0.43,0.0
A09809,6,13,0,19,0.32,0.68,0.0
A09810,5,11,0,16,0.31,0.69,0.0
A09811,32,25,0,57,0.56,0.44,0.0
A09812,18,9,0,27,0.67,0.33,0.0
A09813,2,1,0,3,0.67,0.33,0.0
A09814,8,6,0,14,0.57,0.43,0.0
A09815,0,6,0,6,0.0,1.0,0.0
A09816,9,8,5,22,0.41,0.36,0.23
A09817,2,4,0,6,0.33,0.67,0.0
A09818,4,0,0,4,1.0,0.0,0.0
A09819,3,3,0,6,0.5,0.5,0.0
A09820,3,3,0,6,0.5,0.5,0.0
A09821,16,19,2,37,0.43,0.51,0.05
A09822,7,5,0,12,0.58,0.42,0.0
A09823,0,1,0,1,0.0,1.0,0.0
A09824,1,3,0,4,0.25,0.75,0.0
A09825,9,7,0,16,0.56,0.44,0.0
A09826,11,6,0,17,0.65,0.35,0.0
A09827,3,5,0,8,0.38,0.62,0.0
A09828,4,12,0,16,0.25,0.75,0.0
A09829,6,9,0,15,0.4,0.6,0.0
A09830,0,3,0,3,0.0,1.0,0.0
A09831,1,5,0,6,0.17,0.83,0.0
A09832,1,6,0,7,0.14,0.86,0.0
A09833,5,11,0,16,0.31,0.69,0.0
A09834,11,5,0,16,0.69,0.31,0.0
A09836,6,7,0,13,0.46,0.54,0.0
A09837,162,51,0,213,0.76,0.24,0.0
A09838,2,1,0,3,0.67,0.33,0.0
A09839,2,3,0,5,0.4,0.6,0.0
A09840,6,12,0,18,0.33,0.67,0.0
A09841,5,9,0,14,0.36,0.64,0.0
A09842,2,2,0,4,0.5,0.5,0.0
A09843,1,0,0,1,1.0,0.0,0.0
A09844,45,24,0,69,0.65,0.35,0.0
A09845,0,3,0,3,0.0,1.0,0.0
A09846,1,1,0,2,0.5,0.5,0.0
A09847,4,9,0,13,0.31,0.69,0.0
A09848,0,4,0,4,0.0,1.0,0.0
A09850,24,8,0,32,0.75,0.25,0.0
A09851,3,6,0,9,0.33,0.67,0.0
A09852,11,5,0,16,0.69,0.31,0.0
A09853,5,36,0,41,0.12,0.88,0.0
A09854,6,16,0,22,0.27,0.73,0.0
A09855,11,21,0,32,0.34,0.66,0.0
A09856,24,20,0,44,0.55,0.45,0.0
A09857,1,4,0,5,0.2,0.8,0.0
A09858,11,9,0,20,0.55,0.45,0.0
A09859,0,2,0,2,0.0,1.0,0.0
A09863,0,5,0,5,0.0,1.0,0.0
A09864,25,9,0,34,0.74,0.26,0.0
A09865,9,14,0,23,0.39,0.61,0.0
A09866,8,5,0,13,0.62,0.38,0.0
A09867,0,3,0,3,0.0,1.0,0.0
A09868,1,2,0,3,0.33,0.67,0.0
A09869,4,8,0,12,0.33,0.67,0.0
A09870,8,5,0,13,0.62,0.38,0.0
A09871,5,8,0,13,0.38,0.62,0.0
A09872,1,5,0,6,0.17,0.83,0.0
A09873,1,6,0,7,0.14,0.86,0.0
A09876,11,3,0,14,0.79,0.21,0.0
A09877,1,6,0,7,0.14,0.86,0.0
A09879,9,20,0,29,0.31,0.69,0.0
A09880,0,6,0,6,0.0,1.0,0.0
A09881,3,5,0,8,0.38,0.62,0.0
A09883,1,2,0,3,0.33,0.67,0.0
A09884,3,10,0,13,0.23,0.77,0.0
A09885,13,8,0,21,0.62,0.38,0.0
A09886,3,11,0,14,0.21,0.79,0.0
A09888,0,2,0,2,0.0,1.0,0.0
A09889,21,13,0,34,0.62,0.38,0.0
A09890,2,3,0,5,0.4,0.6,0.0
A09891,0,3,0,3,0.0,1.0,0.0
A09892,1,2,0,3,0.33,0.67,0.0
A09893,0,3,0,3,0.0,1.0,0.0
A09894,2,4,0,6,0.33,0.67,0.0
A09895,6,19,0,25,0.24,0.76,0.0
A09896,6,11,0,17,0.35,0.65,0.0
A09897,3,2,1,6,0.5,0.33,0.17
A09898,1,1,0,2,0.5,0.5,0.0
A09899,11,7,0,18,0.61,0.39,0.0
A09900,37,9,0,46,0.8,0.2,0.0
A09901,5,7,0,12,0.42,0.58,0.0
A09902,2,4,0,6,0.33,0.67,0.0
A09903,0,4,0,4,0.0,1.0,0.0
A09904,11,14,0,25,0.44,0.56,0.0
A09905,7,6,0,13,0.54,0.46,0.0
A09906,1,1,0,2,0.5,0.5,0.0
A09907,6,14,0,20,0.3,0.7,0.0
A09908,0,4,0,4,0.0,1.0,0.0
A09909,0,1,0,1,0.0,1.0,0.0
A09910,15,8,0,23,0.65,0.35,0.0
A09911,1,1,0,2,0.5,0.5,0.0
A09912,1,0,0,1,1.0,0.0,0.0
A09913,46,30,0,76,0.61,0.39,0.0
A09914,0,1,0,1,0.0,1.0,0.0
A09916,0,1,0,1,0.0,1.0,0.0
A09917,2,6,0,8,0.25,0.75,0.0
A09919,17,8,0,25,0.68,0.32,0.0
A09920,4,3,0,7,0.57,0.43,0.0
A09921,8,6,0,14,0.57,0.43,0.0
A09922,30,13,0,43,0.7,0.3,0.0
A09924,2,2,0,4,0.5,0.5,0.0
A09925,8,1,0,9,0.89,0.11,0.0
A09926,2,3,0,5,0.4,0.6,0.0
A09927,14,10,0,24,0.58,0.42,0.0
A09928,6,3,0,9,0.67,0.33,0.0
A09929,16,11,0,27,0.59,0.41,0.0
A09930,1,2,0,3,0.33,0.67,0.0
A09931,28,9,0,37,0.76,0.24,0.0
A09932,4,1,0,5,0.8,0.2,0.0
A09933,4,3,0,7,0.57,0.43,0.0
A09934,24,3,1,28,0.86,0.11,0.04
A09935,0,2,0,2,0.0,1.0,0.0
A09936,0,2,0,2,0.0,1.0,0.0
A09937,9,3,0,12,0.75,0.25,0.0
A09939,3,4,0,7,0.43,0.57,0.0
A09940,5,7,0,12,0.42,0.58,0.0
A09941,0,2,0,2,0.0,1.0,0.0
A09945,0,1,0,1,0.0,1.0,0.0
A09949,1,0,0,1,1.0,0.0,0.0
A09953,2,5,0,7,0.29,0.71,0.0
A09954,1,0,0,1,1.0,0.0,0.0
A09955,2,2,0,4,0.5,0.5,0.0
A09957,10,4,1,15,0.67,0.27,0.07
A09958,2,3,0,5,0.4,0.6,0.0
A09959,16,5,0,21,0.76,0.24,0.0
A09960,1,1,0,2,0.5,0.5,0.0
A09961,9,7,0,16,0.56,0.44,0.0
A09962,1,5,0,6,0.17,0.83,0.0
A09964,15,1,0,16,0.94,0.06,0.0
A09965,5,2,0,7,0.71,0.29,0.0
A09966,7,8,2,17,0.41,0.47,0.12
A09967,3,4,0,7,0.43,0.57,0.0
A09968,29,23,1,53,0.55,0.43,0.02
A09969,3,1,0,4,0.75,0.25,0.0
A09970,8,4,0,12,0.67,0.33,0.0
A09971,19,11,0,30,0.63,0.37,0.0
A09973,14,6,0,20,0.7,0.3,0.0
A09975,5,11,0,16,0.31,0.69,0.0
A09976,8,10,0,18,0.44,0.56,0.0
A09977,28,10,0,38,0.74,0.26,0.0
A09978,15,14,0,29,0.52,0.48,0.0
A09979,3,1,0,4,0.75,0.25,0.0
A09980,1,5,0,6,0.17,0.83,0.0
A09981,9,7,0,16,0.56,0.44,0.0
A09982,10,4,0,14,0.71,0.29,0.0
A09983,3,4,0,7,0.43,0.57,0.0
A09986,0,2,0,2,0.0,1.0,0.0
A09987,5,8,0,13,0.38,0.62,0.0
A09988,15,11,0,26,0.58,0.42,0.0
A09989,1,0,0,1,1.0,0.0,0.0
A09990,3,2,0,5,0.6,0.4,0.0
A09991,7,16,0,23,0.3,0.7,0.0
A09992,10,4,0,14,0.71,0.29,0.0
A09993,2,3,0,5,0.4,0.6,0.0
A09994,12,12,0,24,0.5,0.5,0.0
A09998,1,3,0,4,0.25,0.75,0.0
A09999,0,3,0,3,0.0,1.0,0.0
A10000,1,6,0,7,0.14,0.86,0.0
A10001,9,16,0,25,0.36,0.64,0.0
A10002,3,4,0,7,0.43,0.57,0.0
A10003,0,4,0,4,0.0,1.0,0.0
A10004,2,6,0,8,0.25,0.75,0.0
A10005,19,7,0,26,0.73,0.27,0.0
A10006,2,5,0,7,0.29,0.71,0.0
A10007,1,2,0,3,0.33,0.67,0.0
A10008,2,13,0,15,0.13,0.87,0.0
A10009,11,16,0,27,0.41,0.59,0.0
A10010,2,6,1,9,0.22,0.67,0.11
A10011,0,6,0,6,0.0,1.0,0.0
A10012,2,1,0,3,0.67,0.33,0.0
A10013,12,14,0,26,0.46,0.54,0.0
A10014,0,1,0,1,0.0,1.0,0.0
A10015,3,2,0,5,0.6,0.4,0.0
A10016,1,3,0,4,0.25,0.75,0.0
A10017,6,10,2,18,0.33,0.56,0.11
A10018,0,1,0,1,0.0,1.0,0.0
A10019,0,1,0,1,0.0,1.0,0.0
A10020,4,4,0,8,0.5,0.5,0.0
A10021,1,6,0,7,0.14,0.86,0.0
A10022,1,6,0,7,0.14,0.86,0.0
A10023,1,2,0,3,0.33,0.67,0.0
A10026,6,0,0,6,1.0,0.0,0.0
A10027,9,0,33,42,0.21,0.0,0.79
A10028,0,2,0,2,0.0,1.0,0.0
A10029,1,2,0,3,0.33,0.67,0.0
A10030,3,4,0,7,0.43,0.57,0.0
A10031,27,29,0,56,0.48,0.52,0.0
A10032,0,1,0,1,0.0,1.0,0.0
A10033,49,51,4,104,0.47,0.49,0.04
A10034,1,1,0,2,0.5,0.5,0.0
A10035,2,3,0,5,0.4,0.6,0.0
A10036,4,4,0,8,0.5,0.5,0.0
A10037,10,5,0,15,0.67,0.33,0.0
A10038,1,0,0,1,1.0,0.0,0.0
A10039,0,6,0,6,0.0,1.0,0.0
A10040,5,4,7,16,0.31,0.25,0.44
A10041,12,13,0,25,0.48,0.52,0.0
A10042,2,2,0,4,0.5,0.5,0.0
A10044,18,10,0,28,0.64,0.36,0.0
A10045,1,8,0,9,0.11,0.89,0.0
A10046,8,11,0,19,0.42,0.58,0.0
A10047,0,1,0,1,0.0,1.0,0.0
A10048,3,1,0,4,0.75,0.25,0.0
A10049,1,2,0,3,0.33,0.67,0.0
A10050,6,6,0,12,0.5,0.5,0.0
A10051,2,5,0,7,0.29,0.71,0.0
A10052,9,7,0,16,0.56,0.44,0.0
A10053,0,5,0,5,0.0,1.0,0.0
A10054,7,2,6,15,0.47,0.13,0.4
A10055,15,3,0,18,0.83,0.17,0.0
A10056,9,5,0,14,0.64,0.36,0.0
A10057,4,11,0,15,0.27,0.73,0.0
A10058,1,4,0,5,0.2,0.8,0.0
A10059,3,11,0,14,0.21,0.79,0.0
A10060,1,2,0,3,0.33,0.67,0.0
A10062,3,4,0,7,0.43,0.57,0.0
A10063,1,1,0,2,0.5,0.5,0.0
A10064,0,5,0,5,0.0,1.0,0.0
A10065,25,7,0,32,0.78,0.22,0.0
A10066,2,0,0,2,1.0,0.0,0.0
A10067,0,2,0,2,0.0,1.0,0.0
A10069,1,3,0,4,0.25,0.75,0.0
A10070,11,17,0,28,0.39,0.61,0.0
A10071,4,4,0,8,0.5,0.5,0.0
A10072,8,1,0,9,0.89,0.11,0.0
A10073,6,6,0,12,0.5,0.5,0.0
A10074,12,11,0,23,0.52,0.48,0.0
A10075,6,12,0,18,0.33,0.67,0.0
A10076,1,2,0,3,0.33,0.67,0.0
A10077,8,5,0,13,0.62,0.38,0.0
A10078,19,19,0,38,0.5,0.5,0.0
A10079,4,2,0,6,0.67,0.33,0.0
A10080,6,2,0,8,0.75,0.25,0.0
A10081,0,5,0,5,0.0,1.0,0.0
A10082,1,6,0,7,0.14,0.86,0.0
A10083,14,3,0,17,0.82,0.18,0.0
A10084,1,3,0,4,0.25,0.75,0.0
A10086,11,14,0,25,0.44,0.56,0.0
A10087,2,3,0,5,0.4,0.6,0.0
A10088,3,5,0,8,0.38,0.62,0.0
A10089,0,2,0,2,0.0,1.0,0.0
A10090,8,10,0,18,0.44,0.56,0.0
A10091,14,15,0,29,0.48,0.52,0.0
A10093,16,5,0,21,0.76,0.24,0.0
A10095,1,1,0,2,0.5,0.5,0.0
A10096,0,1,0,1,0.0,1.0,0.0
A10097,4,16,0,20,0.2,0.8,0.0
A10098,1,5,0,6,0.17,0.83,0.0
A10101,0,3,0,3,0.0,1.0,0.0
A10105,10,15,0,25,0.4,0.6,0.0
A10106,6,7,0,13,0.46,0.54,0.0
A10107,10,9,0,19,0.53,0.47,0.0
A10108,0,2,0,2,0.0,1.0,0.0
A10109,6,13,0,19,0.32,0.68,0.0
A10110,0,5,0,5,0.0,1.0,0.0
A10111,0,4,0,4,0.0,1.0,0.0
A10112,0,1,0,1,0.0,1.0,0.0
A10114,1,1,0,2,0.5,0.5,0.0
A10115,0,2,0,2,0.0,1.0,0.0
A10116,7,10,0,17,0.41,0.59,0.0
A10117,0,1,0,1,0.0,1.0,0.0
A10118,2,2,0,4,0.5,0.5,0.0
A10119,8,7,0,15,0.53,0.47,0.0
A10120,0,4,0,4,0.0,1.0,0.0
A10121,1,1,0,2,0.5,0.5,0.0
A10123,13,14,0,27,0.48,0.52,0.0
A10124,0,0,3,3,0.0,0.0,1.0
A10125,0,1,0,1,0.0,1.0,0.0
A10126,0,1,0,1,0.0,1.0,0.0
A10128,1,1,0,2,0.5,0.5,0.0
A10129,26,24,0,50,0.52,0.48,0.0
A10130,2,1,0,3,0.67,0.33,0.0
A10131,0,4,0,4,0.0,1.0,0.0
A10132,0,3,0,3,0.0,1.0,0.0
A10133,2,2,0,4,0.5,0.5,0.0
A10135,0,3,0,3,0.0,1.0,0.0
A10138,0,4,0,4,0.0,1.0,0.0
A10139,0,3,0,3,0.0,1.0,0.0
A10140,14,32,0,46,0.3,0.7,0.0
A10141,0,1,0,1,0.0,1.0,0.0
A10142,1,2,0,3,0.33,0.67,0.0
A10143,0,3,0,3,0.0,1.0,0.0
A10144,0,4,0,4,0.0,1.0,0.0
A10145,0,3,0,3,0.0,1.0,0.0
A10146,7,5,2,14,0.5,0.36,0.14
A10147,0,4,0,4,0.0,1.0,0.0
A10148,0,1,0,1,0.0,1.0,0.0
A10149,27,22,0,49,0.55,0.45,0.0
A10150,2,1,0,3,0.67,0.33,0.0
A10151,1,1,0,2,0.5,0.5,0.0
A10152,0,2,0,2,0.0,1.0,0.0
A10153,9,7,0,16,0.56,0.44,0.0
A10154,3,12,0,15,0.2,0.8,0.0
A10155,0,5,0,5,0.0,1.0,0.0
A10156,4,5,0,9,0.44,0.56,0.0
A10157,3,2,0,5,0.6,0.4,0.0
A10158,0,2,0,2,0.0,1.0,0.0
A10159,7,22,0,29,0.24,0.76,0.0
A10160,1,7,0,8,0.12,0.88,0.0
A10161,33,11,0,44,0.75,0.25,0.0
A10162,8,4,0,12,0.67,0.33,0.0
A10163,0,9,0,9,0.0,1.0,0.0
A10164,1,7,0,8,0.12,0.88,0.0
A10165,1,2,0,3,0.33,0.67,0.0
A10166,3,3,0,6,0.5,0.5,0.0
A10167,0,6,0,6,0.0,1.0,0.0
A10168,6,8,0,14,0.43,0.57,0.0
A10169,7,27,0,34,0.21,0.79,0.0
A10170,11,4,0,15,0.73,0.27,0.0
A10171,4,2,0,6,0.67,0.33,0.0
A10172,2,5,0,7,0.29,0.71,0.0
A10173,1,6,0,7,0.14,0.86,0.0
A10174,18,3,0,21,0.86,0.14,0.0
A10175,2,5,0,7,0.29,0.71,0.0
A10176,2,7,0,9,0.22,0.78,0.0
A10177,1,3,0,4,0.25,0.75,0.0
A10178,3,12,0,15,0.2,0.8,0.0
A10179,22,13,0,35,0.63,0.37,0.0
A10180,3,13,0,16,0.19,0.81,0.0
A10181,13,15,0,28,0.46,0.54,0.0
A10182,9,13,0,22,0.41,0.59,0.0
A10183,36,9,0,45,0.8,0.2,0.0
A10184,11,6,0,17,0.65,0.35,0.0
A10185,69,17,0,86,0.8,0.2,0.0
A10188,29,9,0,38,0.76,0.24,0.0
A10189,1,5,0,6,0.17,0.83,0.0
A10190,54,12,0,66,0.82,0.18,0.0
A10191,1,5,0,6,0.17,0.83,0.0
A10192,0,4,0,4,0.0,1.0,0.0
A10193,1,8,0,9,0.11,0.89,0.0
A10194,1,4,0,5,0.2,0.8,0.0
A10195,25,24,0,49,0.51,0.49,0.0
A10197,1,2,0,3,0.33,0.67,0.0
A10198,0,5,0,5,0.0,1.0,0.0
A10199,3,6,0,9,0.33,0.67,0.0
A10200,0,3,0,3,0.0,1.0,0.0
A10201,9,7,0,16,0.56,0.44,0.0
A10203,0,1,0,1,0.0,1.0,0.0
A10204,1,1,0,2,0.5,0.5,0.0
A10205,6,7,0,13,0.46,0.54,0.0
A10206,0,3,0,3,0.0,1.0,0.0
A10208,0,2,0,2,0.0,1.0,0.0
A10209,13,5,0,18,0.72,0.28,0.0
A10211,7,1,0,8,0.88,0.12,0.0
A10212,13,3,0,16,0.81,0.19,0.0
A10213,3,1,0,4,0.75,0.25,0.0
A10214,8,17,0,25,0.32,0.68,0.0
A10215,5,16,0,21,0.24,0.76,0.0
A10216,1,2,0,3,0.33,0.67,0.0
A10217,2,1,0,3,0.67,0.33,0.0
A10219,16,5,0,21,0.76,0.24,0.0
A10220,18,12,0,30,0.6,0.4,0.0
A10221,5,0,0,5,1.0,0.0,0.0
A10222,4,5,0,9,0.44,0.56,0.0
A10223,8,8,0,16,0.5,0.5,0.0
A10225,3,5,0,8,0.38,0.62,0.0
A10226,14,3,0,17,0.82,0.18,0.0
A10227,2,4,0,6,0.33,0.67,0.0
A10228,10,9,0,19,0.53,0.47,0.0
A10229,0,1,0,1,0.0,1.0,0.0
A10230,6,11,0,17,0.35,0.65,0.0
A10231,3,3,0,6,0.5,0.5,0.0
A10232,6,8,0,14,0.43,0.57,0.0
A10233,11,9,0,20,0.55,0.45,0.0
A10234,7,6,0,13,0.54,0.46,0.0
A10235,2,16,0,18,0.11,0.89,0.0
A10236,2,6,0,8,0.25,0.75,0.0
A10237,1,1,0,2,0.5,0.5,0.0
A10238,1,5,0,6,0.17,0.83,0.0
A10239,52,101,2,155,0.34,0.65,0.01
A10240,3,1,0,4,0.75,0.25,0.0
A10241,6,3,0,9,0.67,0.33,0.0
A10242,12,7,0,19,0.63,0.37,0.0
A10243,2,0,2,4,0.5,0.0,0.5
A10244,2,3,0,5,0.4,0.6,0.0
A10246,10,16,2,28,0.36,0.57,0.07
A10247,0,1,0,1,0.0,1.0,0.0
A10248,8,4,0,12,0.67,0.33,0.0
A10249,1,1,0,2,0.5,0.5,0.0
A10250,13,11,0,24,0.54,0.46,0.0
A10251,20,10,0,30,0.67,0.33,0.0
A10252,59,11,0,70,0.84,0.16,0.0
A10253,4,2,0,6,0.67,0.33,0.0
A10254,1,1,0,2,0.5,0.5,0.0
A10255,7,8,1,16,0.44,0.5,0.06
A10256,1,1,0,2,0.5,0.5,0.0
A10257,8,2,0,10,0.8,0.2,0.0
A10258,2,4,0,6,0.33,0.67,0.0
A10259,15,11,0,26,0.58,0.42,0.0
A10261,3,9,0,12,0.25,0.75,0.0
A10262,9,13,0,22,0.41,0.59,0.0
A10263,24,11,0,35,0.69,0.31,0.0
A10264,10,10,0,20,0.5,0.5,0.0
A10265,8,4,1,13,0.62,0.31,0.08
A10266,0,4,0,4,0.0,1.0,0.0
A10267,1,2,0,3,0.33,0.67,0.0
A10268,18,9,0,27,0.67,0.33,0.0
A10269,48,34,0,82,0.59,0.41,0.0
A10270,2,3,0,5,0.4,0.6,0.0
A10271,3,18,0,21,0.14,0.86,0.0
A10272,5,2,0,7,0.71,0.29,0.0
A10273,5,7,0,12,0.42,0.58,0.0
A10274,9,7,0,16,0.56,0.44,0.0
A10275,26,8,0,34,0.76,0.24,0.0
A10276,3,6,0,9,0.33,0.67,0.0
A10277,14,15,0,29,0.48,0.52,0.0
A10278,17,13,0,30,0.57,0.43,0.0
A10279,2,2,0,4,0.5,0.5,0.0
A10280,10,16,0,26,0.38,0.62,0.0
A10281,0,2,0,2,0.0,1.0,0.0
A10282,1,8,0,9,0.11,0.89,0.0
A10283,4,10,0,14,0.29,0.71,0.0
A10284,0,5,0,5,0.0,1.0,0.0
A10285,14,11,0,25,0.56,0.44,0.0
A10286,6,6,0,12,0.5,0.5,0.0
A10287,3,2,0,5,0.6,0.4,0.0
A10288,14,7,0,21,0.67,0.33,0.0
A10289,22,17,0,39,0.56,0.44,0.0
A10290,44,18,0,62,0.71,0.29,0.0
A10291,4,13,0,17,0.24,0.76,0.0
A10292,0,5,0,5,0.0,1.0,0.0
A10293,1,1,0,2,0.5,0.5,0.0
A10294,6,7,0,13,0.46,0.54,0.0
A10295,10,10,0,20,0.5,0.5,0.0
A10296,3,3,0,6,0.5,0.5,0.0
A10297,3,4,0,7,0.43,0.57,0.0
A10298,12,4,0,16,0.75,0.25,0.0
A10299,2,6,0,8,0.25,0.75,0.0
A10300,1,2,0,3,0.33,0.67,0.0
A10301,3,4,0,7,0.43,0.57,0.0
A10302,19,4,0,23,0.83,0.17,0.0
A10303,2,3,0,5,0.4,0.6,0.0
A10304,1,4,0,5,0.2,0.8,0.0
A10305,1,2,0,3,0.33,0.67,0.0
A10306,1,4,0,5,0.2,0.8,0.0
A10307,2,13,0,15,0.13,0.87,0.0
A10308,43,31,0,74,0.58,0.42,0.0
A10309,7,6,0,13,0.54,0.46,0.0
A10310,0,2,0,2,0.0,1.0,0.0
A10315,0,9,0,9,0.0,1.0,0.0
A10316,0,2,0,2,0.0,1.0,0.0
A10317,0,4,0,4,0.0,1.0,0.0
A10318,1,4,0,5,0.2,0.8,0.0
A10319,17,18,0,35,0.49,0.51,0.0
A10320,31,29,0,60,0.52,0.48,0.0
A10321,4,4,0,8,0.5,0.5,0.0
A10322,4,5,0,9,0.44,0.56,0.0
A10323,0,1,0,1,0.0,1.0,0.0
A10324,0,3,0,3,0.0,1.0,0.0
A10325,2,5,0,7,0.29,0.71,0.0
A10326,16,17,0,33,0.48,0.52,0.0
A10327,0,3,0,3,0.0,1.0,0.0
A10328,3,5,0,8,0.38,0.62,0.0
A10329,9,5,0,14,0.64,0.36,0.0
A10330,2,4,0,6,0.33,0.67,0.0
A10331,2,6,0,8,0.25,0.75,0.0
A10332,1,1,0,2,0.5,0.5,0.0
A10333,2,3,0,5,0.4,0.6,0.0
A10334,1,3,0,4,0.25,0.75,0.0
A10335,1,8,0,9,0.11,0.89,0.0
A10336,1,1,0,2,0.5,0.5,0.0
A10340,0,1,0,1,0.0,1.0,0.0
A10341,4,4,0,8,0.5,0.5,0.0
A10343,14,13,0,27,0.52,0.48,0.0
A10344,62,42,0,104,0.6,0.4,0.0
A10345,4,3,0,7,0.57,0.43,0.0
A10346,0,3,0,3,0.0,1.0,0.0
A10347,29,27,0,56,0.52,0.48,0.0
A10348,6,6,0,12,0.5,0.5,0.0
A10349,0,6,0,6,0.0,1.0,0.0
A10350,7,8,0,15,0.47,0.53,0.0
A10351,100,48,0,148,0.68,0.32,0.0
A10352,0,4,0,4,0.0,1.0,0.0
A10353,4,8,0,12,0.33,0.67,0.0
A10354,25,14,0,39,0.64,0.36,0.0
A10355,0,1,0,1,0.0,1.0,0.0
A10357,18,141,0,159,0.11,0.89,0.0
A10358,5,16,0,21,0.24,0.76,0.0
A10359,1,5,0,6,0.17,0.83,0.0
A10360,26,12,0,38,0.68,0.32,0.0
A10361,5,1,0,6,0.83,0.17,0.0
A10362,0,2,0,2,0.0,1.0,0.0
A10363,0,2,0,2,0.0,1.0,0.0
A10364,6,6,0,12,0.5,0.5,0.0
A10365,0,5,0,5,0.0,1.0,0.0
A10366,11,16,0,27,0.41,0.59,0.0
A10367,9,9,0,18,0.5,0.5,0.0
A10368,4,9,0,13,0.31,0.69,0.0
A10370,0,2,0,2,0.0,1.0,0.0
A10371,2,1,0,3,0.67,0.33,0.0
A10372,4,12,0,16,0.25,0.75,0.0
A10373,5,9,0,14,0.36,0.64,0.0
A10374,19,36,0,55,0.35,0.65,0.0
A10375,1,7,0,8,0.12,0.88,0.0
A10376,6,11,0,17,0.35,0.65,0.0
A10377,0,3,0,3,0.0,1.0,0.0
A10378,9,7,0,16,0.56,0.44,0.0
A10380,10,8,0,18,0.56,0.44,0.0
A10381,6,3,0,9,0.67,0.33,0.0
A10382,11,7,0,18,0.61,0.39,0.0
A10383,6,24,0,30,0.2,0.8,0.0
A10385,11,16,0,27,0.41,0.59,0.0
A10386,8,13,0,21,0.38,0.62,0.0
A10387,12,7,0,19,0.63,0.37,0.0
A10388,8,5,0,13,0.62,0.38,0.0
A10389,10,7,0,17,0.59,0.41,0.0
A10394,15,7,0,22,0.68,0.32,0.0
A10396,0,9,0,9,0.0,1.0,0.0
A10397,43,33,0,76,0.57,0.43,0.0
A10398,29,10,0,39,0.74,0.26,0.0
A10399,3,3,0,6,0.5,0.5,0.0
A10400,1,2,0,3,0.33,0.67,0.0
A10401,11,5,0,16,0.69,0.31,0.0
A10402,44,47,0,91,0.48,0.52,0.0
A10403,22,12,0,34,0.65,0.35,0.0
A10404,3,2,0,5,0.6,0.4,0.0
A10405,17,14,0,31,0.55,0.45,0.0
A10406,2,1,0,3,0.67,0.33,0.0
A10407,4,9,0,13,0.31,0.69,0.0
A10408,5,7,0,12,0.42,0.58,0.0
A10409,7,6,0,13,0.54,0.46,0.0
A10410,8,8,0,16,0.5,0.5,0.0
A10411,1,3,0,4,0.25,0.75,0.0
A10412,3,11,0,14,0.21,0.79,0.0
A10413,18,6,0,24,0.75,0.25,0.0
A10414,19,36,0,55,0.35,0.65,0.0
A10415,0,6,0,6,0.0,1.0,0.0
A10416,36,38,0,74,0.49,0.51,0.0
A10417,18,26,0,44,0.41,0.59,0.0
A10418,4,8,0,12,0.33,0.67,0.0
A10419,2,7,0,9,0.22,0.78,0.0
A10420,24,10,0,34,0.71,0.29,0.0
A10421,26,17,0,43,0.6,0.4,0.0
A10422,0,4,0,4,0.0,1.0,0.0
A10423,17,28,2,47,0.36,0.6,0.04
A10424,6,7,0,13,0.46,0.54,0.0
A10425,1,2,0,3,0.33,0.67,0.0
A10426,9,8,0,17,0.53,0.47,0.0
A10427,0,2,0,2,0.0,1.0,0.0
A10428,0,6,0,6,0.0,1.0,0.0
A10429,1,8,0,9,0.11,0.89,0.0
A10430,1,3,0,4,0.25,0.75,0.0
A10431,4,3,0,7,0.57,0.43,0.0
A10432,2,1,0,3,0.67,0.33,0.0
A10433,0,2,0,2,0.0,1.0,0.0
A10435,0,3,0,3,0.0,1.0,0.0
A10436,8,4,0,12,0.67,0.33,0.0
A10437,3,3,0,6,0.5,0.5,0.0
A10438,0,1,0,1,0.0,1.0,0.0
A10439,0,1,0,1,0.0,1.0,0.0
A10440,0,1,0,1,0.0,1.0,0.0
A10442,2,3,0,5,0.4,0.6,0.0
A10443,5,7,0,12,0.42,0.58,0.0
A10444,0,3,0,3,0.0,1.0,0.0
A10449,1,1,0,2,0.5,0.5,0.0
A10450,82,26,0,108,0.76,0.24,0.0
A10452,2,2,0,4,0.5,0.5,0.0
A10453,2,5,0,7,0.29,0.71,0.0
A10454,0,1,0,1,0.0,1.0,0.0
A10455,0,3,0,3,0.0,1.0,0.0
A10456,0,5,0,5,0.0,1.0,0.0
A10457,99,47,0,146,0.68,0.32,0.0
A10458,7,7,0,14,0.5,0.5,0.0
A10459,1,0,0,1,1.0,0.0,0.0
A10460,0,1,0,1,0.0,1.0,0.0
A10461,2,3,0,5,0.4,0.6,0.0
A10462,1,5,0,6,0.17,0.83,0.0
A10463,5,8,1,14,0.36,0.57,0.07
A10466,2,4,0,6,0.33,0.67,0.0
A10468,2,6,0,8,0.25,0.75,0.0
A10469,1,2,0,3,0.33,0.67,0.0
A10470,15,4,0,19,0.79,0.21,0.0
A10471,0,1,0,1,0.0,1.0,0.0
A10472,0,3,0,3,0.0,1.0,0.0
A10473,4,3,0,7,0.57,0.43,0.0
A10474,2,2,0,4,0.5,0.5,0.0
A10475,6,13,0,19,0.32,0.68,0.0
A10476,0,9,0,9,0.0,1.0,0.0
A10477,2,3,1,6,0.33,0.5,0.17
A10478,40,52,0,92,0.43,0.57,0.0
A10479,5,7,0,12,0.42,0.58,0.0
A10480,0,2,0,2,0.0,1.0,0.0
A10481,6,11,0,17,0.35,0.65,0.0
A10482,60,131,0,191,0.31,0.69,0.0
A10483,0,5,0,5,0.0,1.0,0.0
A10484,1,5,0,6,0.17,0.83,0.0
A10485,15,15,0,30,0.5,0.5,0.0
A10486,0,1,0,1,0.0,1.0,0.0
A10487,9,21,0,30,0.3,0.7,0.0
A10488,1,1,0,2,0.5,0.5,0.0
A10489,2,1,0,3,0.67,0.33,0.0
A10490,4,9,0,13,0.31,0.69,0.0
A10491,4,2,0,6,0.67,0.33,0.0
A10492,1,5,0,6,0.17,0.83,0.0
A10493,1,4,0,5,0.2,0.8,0.0
A10494,14,25,0,39,0.36,0.64,0.0
A10495,10,12,0,22,0.45,0.55,0.0
A10496,0,5,0,5,0.0,1.0,0.0
A10497,1,2,0,3,0.33,0.67,0.0
A10498,3,4,0,7,0.43,0.57,0.0
A10499,1,5,0,6,0.17,0.83,0.0
A10500,9,14,0,23,0.39,0.61,0.0
A10501,8,6,0,14,0.57,0.43,0.0
A10502,28,30,0,58,0.48,0.52,0.0
A10503,1,6,0,7,0.14,0.86,0.0
A10504,12,12,0,24,0.5,0.5,0.0
A10505,1,6,0,7,0.14,0.86,0.0
A10507,15,11,0,26,0.58,0.42,0.0
A10508,3,2,0,5,0.6,0.4,0.0
A10509,4,10,0,14,0.29,0.71,0.0
A10510,0,2,0,2,0.0,1.0,0.0
A10512,2,2,0,4,0.5,0.5,0.0
A10513,1,5,0,6,0.17,0.83,0.0
A10514,12,11,0,23,0.52,0.48,0.0
A10515,0,2,0,2,0.0,1.0,0.0
A10516,0,2,0,2,0.0,1.0,0.0
A10517,1,7,0,8,0.12,0.88,0.0
A10518,2,3,0,5,0.4,0.6,0.0
A10519,2,3,1,6,0.33,0.5,0.17
A10521,8,13,0,21,0.38,0.62,0.0
A10522,3,1,0,4,0.75,0.25,0.0
A10523,0,1,0,1,0.0,1.0,0.0
A10524,0,1,0,1,0.0,1.0,0.0
A10525,3,6,0,9,0.33,0.67,0.0
A10526,1,2,0,3,0.33,0.67,0.0
A10527,6,3,0,9,0.67,0.33,0.0
A10528,5,7,0,12,0.42,0.58,0.0
A10529,0,2,0,2,0.0,1.0,0.0
A10530,3,4,0,7,0.43,0.57,0.0
A10531,9,23,0,32,0.28,0.72,0.0
A10532,7,11,0,18,0.39,0.61,0.0
A10533,0,7,0,7,0.0,1.0,0.0
A10534,0,2,0,2,0.0,1.0,0.0
A10535,10,7,0,17,0.59,0.41,0.0
A10536,4,10,0,14,0.29,0.71,0.0
A10537,16,9,0,25,0.64,0.36,0.0
A10538,0,4,0,4,0.0,1.0,0.0
A10539,1,6,0,7,0.14,0.86,0.0
A10540,2,5,0,7,0.29,0.71,0.0
A10542,3,4,0,7,0.43,0.57,0.0
A10543,10,8,0,18,0.56,0.44,0.0
A10544,13,22,0,35,0.37,0.63,0.0
A10546,7,10,0,17,0.41,0.59,0.0
A10547,66,38,0,104,0.63,0.37,0.0
A10550,2,1,0,3,0.67,0.33,0.0
A10551,0,3,0,3,0.0,1.0,0.0
A10552,1,2,0,3,0.33,0.67,0.0
A10553,8,12,0,20,0.4,0.6,0.0
A10554,9,5,0,14,0.64,0.36,0.0
A10555,1,7,0,8,0.12,0.88,0.0
A10556,5,9,0,14,0.36,0.64,0.0
A10557,8,4,0,12,0.67,0.33,0.0
A10558,1,1,0,2,0.5,0.5,0.0
A10560,3,3,0,6,0.5,0.5,0.0
A10561,4,4,0,8,0.5,0.5,0.0
A10562,1,2,0,3,0.33,0.67,0.0
A10563,6,8,0,14,0.43,0.57,0.0
A10564,2,1,0,3,0.67,0.33,0.0
A10565,3,2,0,5,0.6,0.4,0.0
A10566,1,1,0,2,0.5,0.5,0.0
A10567,0,3,0,3,0.0,1.0,0.0
A10568,11,12,0,23,0.48,0.52,0.0
A10569,0,5,0,5,0.0,1.0,0.0
A10570,3,5,0,8,0.38,0.62,0.0
A10573,1,2,0,3,0.33,0.67,0.0
A10574,0,1,0,1,0.0,1.0,0.0
A10575,0,4,0,4,0.0,1.0,0.0
A10576,4,11,0,15,0.27,0.73,0.0
A10577,1,1,0,2,0.5,0.5,0.0
A10578,7,11,0,18,0.39,0.61,0.0
A10579,0,5,0,5,0.0,1.0,0.0
A10581,0,4,0,4,0.0,1.0,0.0
A10582,1,5,0,6,0.17,0.83,0.0
A10583,1,1,0,2,0.5,0.5,0.0
A10584,0,2,0,2,0.0,1.0,0.0
A10585,7,19,0,26,0.27,0.73,0.0
A10586,1,4,0,5,0.2,0.8,0.0
A10588,9,6,0,15,0.6,0.4,0.0
A10589,8,16,0,24,0.33,0.67,0.0
A10590,0,4,0,4,0.0,1.0,0.0
A10591,2,5,0,7,0.29,0.71,0.0
A10592,2,2,0,4,0.5,0.5,0.0
A10593,2,5,0,7,0.29,0.71,0.0
A10594,0,6,0,6,0.0,1.0,0.0
A10595,1,1,0,2,0.5,0.5,0.0
A10596,5,7,0,12,0.42,0.58,0.0
A10597,0,1,0,1,0.0,1.0,0.0
A10598,0,1,0,1,0.0,1.0,0.0
A10599,1,2,0,3,0.33,0.67,0.0
A10600,4,3,0,7,0.57,0.43,0.0
A10601,1,1,0,2,0.5,0.5,0.0
A10602,0,1,0,1,0.0,1.0,0.0
A10603,1,6,0,7,0.14,0.86,0.0
A10604,1,6,0,7,0.14,0.86,0.0
A10605,3,9,0,12,0.25,0.75,0.0
A10606,8,12,0,20,0.4,0.6,0.0
A10607,0,1,0,1,0.0,1.0,0.0
A10608,1,1,0,2,0.5,0.5,0.0
A10609,8,10,0,18,0.44,0.56,0.0
A10610,0,8,0,8,0.0,1.0,0.0
A10612,1,3,0,4,0.25,0.75,0.0
A10614,8,1,0,9,0.89,0.11,0.0
A10617,2,1,0,3,0.67,0.33,0.0
A10618,0,1,0,1,0.0,1.0,0.0
A10619,0,4,0,4,0.0,1.0,0.0
A10620,1,6,0,7,0.14,0.86,0.0
A10621,5,1,0,6,0.83,0.17,0.0
A10622,6,7,0,13,0.46,0.54,0.0
A10625,5,25,0,30,0.17,0.83,0.0
A10626,1,3,0,4,0.25,0.75,0.0
A10627,0,4,0,4,0.0,1.0,0.0
A10628,20,37,0,57,0.35,0.65,0.0
A10629,0,1,0,1,0.0,1.0,0.0
A10630,5,34,0,39,0.13,0.87,0.0
A10632,1,1,0,2,0.5,0.5,0.0
A10633,6,13,0,19,0.32,0.68,0.0
A10634,14,11,0,25,0.56,0.44,0.0
A10635,5,7,0,12,0.42,0.58,0.0
A10636,0,5,0,5,0.0,1.0,0.0
A10637,1,6,0,7,0.14,0.86,0.0
A10638,8,10,0,18,0.44,0.56,0.0
A10639,3,5,0,8,0.38,0.62,0.0
A10640,0,1,0,1,0.0,1.0,0.0
A10641,3,12,0,15,0.2,0.8,0.0
A10642,4,12,0,16,0.25,0.75,0.0
A10643,6,3,0,9,0.67,0.33,0.0
A10644,1,6,0,7,0.14,0.86,0.0
A10645,2,3,0,5,0.4,0.6,0.0
A10646,10,3,0,13,0.77,0.23,0.0
A10648,3,9,0,12,0.25,0.75,0.0
A10649,12,5,0,17,0.71,0.29,0.0
A10650,30,34,0,64,0.47,0.53,0.0
A10651,0,1,0,1,0.0,1.0,0.0
A10652,1,7,0,8,0.12,0.88,0.0
A10653,1,6,0,7,0.14,0.86,0.0
A10654,3,5,0,8,0.38,0.62,0.0
A10655,1,1,0,2,0.5,0.5,0.0
A10656,3,2,0,5,0.6,0.4,0.0
A10658,5,8,0,13,0.38,0.62,0.0
A10659,10,6,0,16,0.62,0.38,0.0
A10660,3,4,0,7,0.43,0.57,0.0
A10661,3,2,0,5,0.6,0.4,0.0
A10662,6,7,0,13,0.46,0.54,0.0
A10663,0,3,0,3,0.0,1.0,0.0
A10664,0,1,0,1,0.0,1.0,0.0
A10666,0,2,0,2,0.0,1.0,0.0
A10667,11,15,0,26,0.42,0.58,0.0
A10668,0,1,0,1,0.0,1.0,0.0
A10669,0,2,0,2,0.0,1.0,0.0
A10670,0,1,0,1,0.0,1.0,0.0
A10671,1,1,1,3,0.33,0.33,0.33
A10672,5,17,0,22,0.23,0.77,0.0
A10673,1,2,0,3,0.33,0.67,0.0
A10675,8,7,6,21,0.38,0.33,0.29
A10676,12,7,0,19,0.63,0.37,0.0
A10677,1,0,0,1,1.0,0.0,0.0
A10678,17,6,0,23,0.74,0.26,0.0
A10679,3,3,0,6,0.5,0.5,0.0
A10680,0,4,0,4,0.0,1.0,0.0
A10681,2,4,0,6,0.33,0.67,0.0
A10682,2,1,0,3,0.67,0.33,0.0
A10683,2,7,0,9,0.22,0.78,0.0
A10684,2,1,0,3,0.67,0.33,0.0
A10685,1,2,0,3,0.33,0.67,0.0
A10686,12,7,0,19,0.63,0.37,0.0
A10687,0,4,0,4,0.0,1.0,0.0
A10688,1,2,0,3,0.33,0.67,0.0
A10689,10,3,0,13,0.77,0.23,0.0
A10690,9,9,0,18,0.5,0.5,0.0
A10691,0,3,0,3,0.0,1.0,0.0
A10692,6,8,0,14,0.43,0.57,0.0
A10693,7,6,0,13,0.54,0.46,0.0
A10694,0,3,0,3,0.0,1.0,0.0
A10695,7,9,0,16,0.44,0.56,0.0
A10696,3,3,0,6,0.5,0.5,0.0
A10697,1,2,0,3,0.33,0.67,0.0
A10700,1,2,0,3,0.33,0.67,0.0
A10702,3,2,0,5,0.6,0.4,0.0
A10703,19,11,0,30,0.63,0.37,0.0
A10704,0,2,0,2,0.0,1.0,0.0
A10705,0,1,0,1,0.0,1.0,0.0
A10706,20,23,0,43,0.47,0.53,0.0
A10707,0,1,0,1,0.0,1.0,0.0
A10708,7,15,0,22,0.32,0.68,0.0
A10709,4,3,0,7,0.57,0.43,0.0
A10710,11,8,0,19,0.58,0.42,0.0
A10711,12,10,0,22,0.55,0.45,0.0
A10714,24,9,1,34,0.71,0.26,0.03
A10715,3,5,0,8,0.38,0.62,0.0
A10716,0,8,0,8,0.0,1.0,0.0
A10717,2,7,0,9,0.22,0.78,0.0
A10718,2,4,0,6,0.33,0.67,0.0
A10719,2,2,0,4,0.5,0.5,0.0
A10720,5,9,0,14,0.36,0.64,0.0
A10721,6,2,0,8,0.75,0.25,0.0
A10722,60,26,1,87,0.69,0.3,0.01
A10723,1,0,0,1,1.0,0.0,0.0
A10724,0,3,0,3,0.0,1.0,0.0
A10725,17,8,0,25,0.68,0.32,0.0
A10726,0,1,0,1,0.0,1.0,0.0
A10727,2,5,0,7,0.29,0.71,0.0
A10728,1,1,0,2,0.5,0.5,0.0
A10729,0,5,0,5,0.0,1.0,0.0
A10730,4,1,0,5,0.8,0.2,0.0
A10733,5,11,0,16,0.31,0.69,0.0
A10734,3,5,0,8,0.38,0.62,0.0
A10735,0,1,0,1,0.0,1.0,0.0
A10736,2,6,0,8,0.25,0.75,0.0
A10737,6,4,0,10,0.6,0.4,0.0
A10738,0,2,0,2,0.0,1.0,0.0
A10739,0,3,0,3,0.0,1.0,0.0
A10740,10,11,0,21,0.48,0.52,0.0
A10744,8,4,0,12,0.67,0.33,0.0
A10745,1,2,0,3,0.33,0.67,0.0
A10746,0,9,0,9,0.0,1.0,0.0
A10747,0,3,0,3,0.0,1.0,0.0
A10748,2,4,0,6,0.33,0.67,0.0
A10749,0,3,0,3,0.0,1.0,0.0
A10750,1,4,0,5,0.2,0.8,0.0
A10751,1,0,0,1,1.0,0.0,0.0
A10753,2,3,0,5,0.4,0.6,0.0
A10754,7,8,0,15,0.47,0.53,0.0
A10758,13,8,0,21,0.62,0.38,0.0
A10760,5,9,0,14,0.36,0.64,0.0
A10761,13,7,0,20,0.65,0.35,0.0
A10763,1,2,0,3,0.33,0.67,0.0
A10765,1,5,0,6,0.17,0.83,0.0
A10766,3,12,0,15,0.2,0.8,0.0
A10767,2,2,0,4,0.5,0.5,0.0
A10768,6,11,0,17,0.35,0.65,0.0
A10769,9,9,0,18,0.5,0.5,0.0
A10770,11,14,0,25,0.44,0.56,0.0
A10771,13,11,0,24,0.54,0.46,0.0
A10772,4,8,0,12,0.33,0.67,0.0
A10773,6,7,0,13,0.46,0.54,0.0
A10774,11,5,0,16,0.69,0.31,0.0
A10775,0,1,0,1,0.0,1.0,0.0
A10776,2,2,0,4,0.5,0.5,0.0
A10777,0,3,0,3,0.0,1.0,0.0
A10778,1,4,0,5,0.2,0.8,0.0
A10779,2,1,0,3,0.67,0.33,0.0
A10780,1,3,0,4,0.25,0.75,0.0
A10781,0,1,0,1,0.0,1.0,0.0
A10782,1,5,0,6,0.17,0.83,0.0
A10783,3,5,0,8,0.38,0.62,0.0
A10784,3,6,0,9,0.33,0.67,0.0
A10785,8,4,0,12,0.67,0.33,0.0
A10786,0,3,0,3,0.0,1.0,0.0
A10787,11,16,0,27,0.41,0.59,0.0
A10788,1,5,0,6,0.17,0.83,0.0
A10789,0,3,0,3,0.0,1.0,0.0
A10790,16,15,0,31,0.52,0.48,0.0
A10791,4,11,0,15,0.27,0.73,0.0
A10792,19,12,0,31,0.61,0.39,0.0
A10793,1,2,0,3,0.33,0.67,0.0
A10794,1,6,0,7,0.14,0.86,0.0
A10795,12,10,0,22,0.55,0.45,0.0
A10796,1,2,0,3,0.33,0.67,0.0
A10798,1,4,0,5,0.2,0.8,0.0
A10800,0,5,0,5,0.0,1.0,0.0
A10801,2,7,0,9,0.22,0.78,0.0
A10802,0,5,0,5,0.0,1.0,0.0
A10803,0,7,0,7,0.0,1.0,0.0
A10804,12,18,0,30,0.4,0.6,0.0
A10805,0,6,0,6,0.0,1.0,0.0
A10806,2,5,0,7,0.29,0.71,0.0
A10807,0,3,0,3,0.0,1.0,0.0
A10808,9,8,0,17,0.53,0.47,0.0
A10809,2,5,0,7,0.29,0.71,0.0
A10810,6,5,0,11,0.55,0.45,0.0
A10811,6,32,0,38,0.16,0.84,0.0
A10812,4,31,0,35,0.11,0.89,0.0
A10813,0,1,0,1,0.0,1.0,0.0
A10814,1,6,0,7,0.14,0.86,0.0
A10815,9,22,0,31,0.29,0.71,0.0
A10816,3,3,0,6,0.5,0.5,0.0
A10817,78,44,0,122,0.64,0.36,0.0
A10818,1,6,0,7,0.14,0.86,0.0
A10819,0,7,0,7,0.0,1.0,0.0
A10820,0,1,0,1,0.0,1.0,0.0
A10821,2,5,0,7,0.29,0.71,0.0
A10822,7,12,0,19,0.37,0.63,0.0
A10823,5,7,0,12,0.42,0.58,0.0
A10824,1,2,0,3,0.33,0.67,0.0
A10825,0,1,0,1,0.0,1.0,0.0
A10826,16,14,0,30,0.53,0.47,0.0
A10827,10,5,0,15,0.67,0.33,0.0
A10828,11,5,0,16,0.69,0.31,0.0
A10829,2,1,0,3,0.67,0.33,0.0
A10830,13,8,0,21,0.62,0.38,0.0
A10831,0,5,0,5,0.0,1.0,0.0
A10832,8,6,0,14,0.57,0.43,0.0
A10833,7,11,0,18,0.39,0.61,0.0
A10834,11,9,0,20,0.55,0.45,0.0
A10835,0,1,0,1,0.0,1.0,0.0
A10836,4,9,0,13,0.31,0.69,0.0
A10837,14,16,0,30,0.47,0.53,0.0
A10838,1,2,0,3,0.33,0.67,0.0
A10839,2,2,0,4,0.5,0.5,0.0
A10840,9,6,0,15,0.6,0.4,0.0
A10841,3,3,0,6,0.5,0.5,0.0
A10842,4,21,0,25,0.16,0.84,0.0
A10843,1,8,0,9,0.11,0.89,0.0
A10844,0,8,0,8,0.0,1.0,0.0
A10845,1,1,1,3,0.33,0.33,0.33
A10846,0,3,0,3,0.0,1.0,0.0
A10848,2,7,0,9,0.22,0.78,0.0
A10849,14,11,0,25,0.56,0.44,0.0
A10850,3,5,0,8,0.38,0.62,0.0
A10853,1,1,0,2,0.5,0.5,0.0
A10854,0,1,0,1,0.0,1.0,0.0
A10855,6,15,0,21,0.29,0.71,0.0
A10856,4,3,0,7,0.57,0.43,0.0
A10857,0,3,0,3,0.0,1.0,0.0
A10858,23,16,0,39,0.59,0.41,0.0
A10859,3,2,0,5,0.6,0.4,0.0
A10860,3,0,0,3,1.0,0.0,0.0
A10861,1,3,0,4,0.25,0.75,0.0
A10862,19,8,0,27,0.7,0.3,0.0
A10863,0,1,0,1,0.0,1.0,0.0
A10865,0,7,0,7,0.0,1.0,0.0
A10866,1,1,0,2,0.5,0.5,0.0
A10867,6,6,0,12,0.5,0.5,0.0
A10868,1,0,0,1,1.0,0.0,0.0
A10869,14,11,0,25,0.56,0.44,0.0
A10870,26,10,0,36,0.72,0.28,0.0
A10872,1,4,1,6,0.17,0.67,0.17
A10873,1,0,0,1,1.0,0.0,0.0
A10874,48,36,0,84,0.57,0.43,0.0
A10876,1,5,0,6,0.17,0.83,0.0
A10877,35,20,2,57,0.61,0.35,0.04
A10878,0,2,0,2,0.0,1.0,0.0
A10879,10,17,0,27,0.37,0.63,0.0
A10880,0,4,0,4,0.0,1.0,0.0
A10881,27,20,0,47,0.57,0.43,0.0
A10882,1,2,0,3,0.33,0.67,0.0
A10883,2,9,0,11,0.18,0.82,0.0
A10884,0,3,0,3,0.0,1.0,0.0
A10885,3,6,0,9,0.33,0.67,0.0
A10886,10,18,0,28,0.36,0.64,0.0
A10887,6,10,0,16,0.38,0.62,0.0
A10888,1,8,0,9,0.11,0.89,0.0
A10889,7,4,0,11,0.64,0.36,0.0
A10890,3,16,0,19,0.16,0.84,0.0
A10891,3,9,0,12,0.25,0.75,0.0
A10892,0,1,0,1,0.0,1.0,0.0
A10893,12,3,0,15,0.8,0.2,0.0
A10894,4,5,0,9,0.44,0.56,0.0
A10895,6,6,0,12,0.5,0.5,0.0
A10896,8,9,0,17,0.47,0.53,0.0
A10898,2,17,0,19,0.11,0.89,0.0
A10899,6,6,0,12,0.5,0.5,0.0
A10900,44,18,0,62,0.71,0.29,0.0
A10901,1,2,0,3,0.33,0.67,0.0
A10902,7,6,0,13,0.54,0.46,0.0
A10903,1,0,0,1,1.0,0.0,0.0
A10904,17,31,0,48,0.35,0.65,0.0
A10905,11,20,0,31,0.35,0.65,0.0
A10906,3,4,0,7,0.43,0.57,0.0
A10908,1,5,0,6,0.17,0.83,0.0
A10909,1,5,0,6,0.17,0.83,0.0
A10910,7,12,0,19,0.37,0.63,0.0
A10911,0,2,0,2,0.0,1.0,0.0
A10912,2,10,0,12,0.17,0.83,0.0
A10913,7,7,0,14,0.5,0.5,0.0
A10914,15,10,0,25,0.6,0.4,0.0
A10915,6,19,0,25,0.24,0.76,0.0
A10916,16,26,0,42,0.38,0.62,0.0
A10918,8,4,0,12,0.67,0.33,0.0
A10919,3,2,0,5,0.6,0.4,0.0
A10920,18,11,0,29,0.62,0.38,0.0
A10921,60,19,0,79,0.76,0.24,0.0
A10922,4,7,0,11,0.36,0.64,0.0
A10924,13,27,0,40,0.33,0.68,0.0
A10925,5,16,0,21,0.24,0.76,0.0
A10926,2,15,0,17,0.12,0.88,0.0
A10927,5,9,0,14,0.36,0.64,0.0
A10928,2,5,0,7,0.29,0.71,0.0
A10929,10,12,0,22,0.45,0.55,0.0
A10930,2,4,0,6,0.33,0.67,0.0
A10931,3,2,0,5,0.6,0.4,0.0
A10933,7,15,0,22,0.32,0.68,0.0
A10934,8,9,0,17,0.47,0.53,0.0
A10935,0,4,0,4,0.0,1.0,0.0
A10936,5,15,0,20,0.25,0.75,0.0
A10937,6,17,0,23,0.26,0.74,0.0
A10939,15,11,0,26,0.58,0.42,0.0
A10940,1,7,0,8,0.12,0.88,0.0
A10941,8,14,0,22,0.36,0.64,0.0
A10942,2,0,0,2,1.0,0.0,0.0
A10943,0,1,0,1,0.0,1.0,0.0
A10944,446,487,1,934,0.48,0.52,0.0
A10945,168,215,0,383,0.44,0.56,0.0
A10946,5,12,0,17,0.29,0.71,0.0
A10947,7,5,0,12,0.58,0.42,0.0
A10948,2,2,0,4,0.5,0.5,0.0
A10949,9,11,0,20,0.45,0.55,0.0
A10950,16,17,0,33,0.48,0.52,0.0
A10951,25,13,0,38,0.66,0.34,0.0
A10952,18,20,0,38,0.47,0.53,0.0
A10953,2,23,0,25,0.08,0.92,0.0
A10954,0,1,0,1,0.0,1.0,0.0
A10955,26,9,0,35,0.74,0.26,0.0
A10956,2,3,0,5,0.4,0.6,0.0
A10957,1,11,0,12,0.08,0.92,0.0
A10958,2,4,0,6,0.33,0.67,0.0
A10959,11,15,0,26,0.42,0.58,0.0
A10960,17,14,0,31,0.55,0.45,0.0
A10961,4,5,0,9,0.44,0.56,0.0
A10962,5,9,1,15,0.33,0.6,0.07
A10963,3,9,0,12,0.25,0.75,0.0
A10964,10,11,0,21,0.48,0.52,0.0
A10965,21,8,17,46,0.46,0.17,0.37
A10966,1,2,0,3,0.33,0.67,0.0
A10967,11,16,0,27,0.41,0.59,0.0
A10968,7,12,0,19,0.37,0.63,0.0
A10969,2,5,0,7,0.29,0.71,0.0
A10970,1,2,0,3,0.33,0.67,0.0
A10971,2,11,0,13,0.15,0.85,0.0
A10972,27,14,1,42,0.64,0.33,0.02
A10973,13,9,0,22,0.59,0.41,0.0
A10974,18,26,0,44,0.41,0.59,0.0
A10975,9,12,0,21,0.43,0.57,0.0
A10976,2,11,0,13,0.15,0.85,0.0
A10977,11,2,7,20,0.55,0.1,0.35
A10978,39,21,0,60,0.65,0.35,0.0
A10979,34,11,1,46,0.74,0.24,0.02
A10980,11,8,0,19,0.58,0.42,0.0
A10981,1,1,0,2,0.5,0.5,0.0
A10982,1,1,0,2,0.5,0.5,0.0
A10983,3,5,0,8,0.38,0.62,0.0
A10984,0,1,0,1,0.0,1.0,0.0
A10985,7,6,0,13,0.54,0.46,0.0
A10986,18,20,0,38,0.47,0.53,0.0
A10987,8,8,0,16,0.5,0.5,0.0
A10988,1,3,0,4,0.25,0.75,0.0
A10989,0,2,0,2,0.0,1.0,0.0
A10990,3,12,0,15,0.2,0.8,0.0
A10991,2,5,0,7,0.29,0.71,0.0
A10992,10,18,0,28,0.36,0.64,0.0
A10993,2,9,0,11,0.18,0.82,0.0
A10994,5,3,0,8,0.62,0.38,0.0
A10995,23,12,0,35,0.66,0.34,0.0
A10996,0,1,0,1,0.0,1.0,0.0
A10997,1,7,0,8,0.12,0.88,0.0
A10998,6,6,0,12,0.5,0.5,0.0
A10999,1,2,0,3,0.33,0.67,0.0
A11000,3,5,0,8,0.38,0.62,0.0
A11001,19,21,0,40,0.47,0.53,0.0
A11002,1,3,0,4,0.25,0.75,0.0
A11003,2,3,0,5,0.4,0.6,0.0
A11004,2,4,0,6,0.33,0.67,0.0
A11005,10,16,0,26,0.38,0.62,0.0
A11006,14,24,0,38,0.37,0.63,0.0
A11007,0,1,0,1,0.0,1.0,0.0
A11008,1,2,0,3,0.33,0.67,0.0
A11009,2,4,0,6,0.33,0.67,0.0
A11010,5,9,0,14,0.36,0.64,0.0
A11011,3,11,0,14,0.21,0.79,0.0
A11012,265,346,0,611,0.43,0.57,0.0
A11013,6,8,0,14,0.43,0.57,0.0
A11014,3,4,0,7,0.43,0.57,0.0
A11015,678,817,7,1502,0.45,0.54,0.0
A11016,20,13,0,33,0.61,0.39,0.0
A11017,56,75,3,134,0.42,0.56,0.02
A11018,38,26,13,77,0.49,0.34,0.17
A11019,21,18,0,39,0.54,0.46,0.0
A11020,15,17,0,32,0.47,0.53,0.0
A11021,8,21,0,29,0.28,0.72,0.0
A11022,138,51,14,203,0.68,0.25,0.07
A11023,6,12,0,18,0.33,0.67,0.0
A11024,40,44,1,85,0.47,0.52,0.01
A11025,5,9,0,14,0.36,0.64,0.0
A11026,13,12,0,25,0.52,0.48,0.0
A11027,21,17,1,39,0.54,0.44,0.03
A11028,8,5,1,14,0.57,0.36,0.07
A11029,10,15,4,29,0.34,0.52,0.14
A11030,12,26,0,38,0.32,0.68,0.0
A11031,11,48,0,59,0.19,0.81,0.0
A11032,22,20,1,43,0.51,0.47,0.02
A11033,24,30,0,54,0.44,0.56,0.0
A11034,7,6,0,13,0.54,0.46,0.0
A11035,0,4,0,4,0.0,1.0,0.0
A11036,6,9,0,15,0.4,0.6,0.0
A11037,2,4,0,6,0.33,0.67,0.0
A11038,6,7,0,13,0.46,0.54,0.0
A11039,4,8,0,12,0.33,0.67,0.0
A11040,17,11,0,28,0.61,0.39,0.0
A11041,4,0,0,4,1.0,0.0,0.0
A11042,7,47,0,54,0.13,0.87,0.0
A11043,1,8,0,9,0.11,0.89,0.0
A11044,1,2,0,3,0.33,0.67,0.0
A11045,14,10,0,24,0.58,0.42,0.0
A11046,0,1,0,1,0.0,1.0,0.0
A11047,5,7,0,12,0.42,0.58,0.0
A11048,2,3,0,5,0.4,0.6,0.0
A11049,12,26,0,38,0.32,0.68,0.0
A11050,4,4,0,8,0.5,0.5,0.0
A11051,6,7,0,13,0.46,0.54,0.0
A11052,14,15,0,29,0.48,0.52,0.0
A11053,15,9,0,24,0.62,0.38,0.0
A11054,4,4,1,9,0.44,0.44,0.11
A11055,7,8,0,15,0.47,0.53,0.0
A11056,13,13,14,40,0.33,0.33,0.35
A11057,4,5,0,9,0.44,0.56,0.0
A11058,16,12,1,29,0.55,0.41,0.03
A11059,12,8,0,20,0.6,0.4,0.0
A11060,2,7,0,9,0.22,0.78,0.0
A11061,8,15,0,23,0.35,0.65,0.0
A11062,9,19,0,28,0.32,0.68,0.0
A11063,7,4,1,12,0.58,0.33,0.08
A11064,5,15,0,20,0.25,0.75,0.0
A11065,11,8,0,19,0.58,0.42,0.0
A11066,20,6,0,26,0.77,0.23,0.0
A11067,5,7,0,12,0.42,0.58,0.0
A11068,16,13,0,29,0.55,0.45,0.0
A11069,10,24,0,34,0.29,0.71,0.0
A11070,18,27,1,46,0.39,0.59,0.02
A11071,2,1,0,3,0.67,0.33,0.0
A11072,9,8,0,17,0.53,0.47,0.0
A11073,11,14,0,25,0.44,0.56,0.0
A11074,10,12,0,22,0.45,0.55,0.0
A11076,6,7,0,13,0.46,0.54,0.0
A11077,8,15,0,23,0.35,0.65,0.0
A11078,8,11,0,19,0.42,0.58,0.0
A11079,25,21,0,46,0.54,0.46,0.0
A11080,10,7,1,18,0.56,0.39,0.06
A11081,4,12,0,16,0.25,0.75,0.0
A11082,11,17,0,28,0.39,0.61,0.0
A11083,4,5,0,9,0.44,0.56,0.0
A11084,15,11,0,26,0.58,0.42,0.0
A11085,4,18,0,22,0.18,0.82,0.0
A11086,19,17,0,36,0.53,0.47,0.0
A11087,25,14,0,39,0.64,0.36,0.0
A11088,44,49,5,98,0.45,0.5,0.05
A11089,16,5,3,24,0.67,0.21,0.12
A11090,63,33,0,96,0.66,0.34,0.0
A11091,4,7,0,11,0.36,0.64,0.0
A11092,20,23,0,43,0.47,0.53,0.0
A11093,1,4,0,5,0.2,0.8,0.0
A11094,6,13,0,19,0.32,0.68,0.0
A11095,11,25,0,36,0.31,0.69,0.0
A11096,11,10,0,21,0.52,0.48,0.0
A11097,26,23,0,49,0.53,0.47,0.0
A11098,10,12,0,22,0.45,0.55,0.0
A11099,39,38,3,80,0.49,0.47,0.04
A11100,9,6,0,15,0.6,0.4,0.0
A11101,23,17,0,40,0.57,0.42,0.0
A11102,13,10,0,23,0.57,0.43,0.0
A11103,11,8,0,19,0.58,0.42,0.0
A11104,6,5,0,11,0.55,0.45,0.0
A11105,2,9,1,12,0.17,0.75,0.08
A11106,73,14,0,87,0.84,0.16,0.0
A11107,40,44,0,84,0.48,0.52,0.0
A11108,12,8,2,22,0.55,0.36,0.09
A11109,10,19,0,29,0.34,0.66,0.0
A11110,3,10,0,13,0.23,0.77,0.0
A11111,3,3,0,6,0.5,0.5,0.0
A11112,1,4,0,5,0.2,0.8,0.0
A11113,1,4,0,5,0.2,0.8,0.0
A11115,1,1,0,2,0.5,0.5,0.0
A11117,276,21,1,298,0.93,0.07,0.0
A11118,22,10,3,35,0.63,0.29,0.09
A11119,67,10,0,77,0.87,0.13,0.0
A11120,0,3,0,3,0.0,1.0,0.0
A11121,12,8,0,20,0.6,0.4,0.0
A11122,0,1,0,1,0.0,1.0,0.0
A11123,1,1,0,2,0.5,0.5,0.0
A11124,0,1,0,1,0.0,1.0,0.0
A11125,7,18,0,25,0.28,0.72,0.0
A11126,6,9,0,15,0.4,0.6,0.0
A11127,2,22,0,24,0.08,0.92,0.0
A11128,1,3,0,4,0.25,0.75,0.0
A11129,20,24,0,44,0.45,0.55,0.0
A11130,4,7,0,11,0.36,0.64,0.0
A11131,8,6,0,14,0.57,0.43,0.0
A11132,2,2,0,4,0.5,0.5,0.0
A11133,4,1,33,38,0.11,0.03,0.87
A11134,5,7,0,12,0.42,0.58,0.0
A11135,1,3,0,4,0.25,0.75,0.0
A11136,32,20,0,52,0.62,0.38,0.0
A11137,14,13,0,27,0.52,0.48,0.0
A11138,3,7,0,10,0.3,0.7,0.0
A11139,5,3,0,8,0.62,0.38,0.0
A11140,51,40,1,92,0.55,0.43,0.01
A11141,4,11,0,15,0.27,0.73,0.0
A11142,36,10,0,46,0.78,0.22,0.0
A11143,5,7,0,12,0.42,0.58,0.0
A11144,24,60,0,84,0.29,0.71,0.0
A11145,8,15,0,23,0.35,0.65,0.0
A11146,6,18,0,24,0.25,0.75,0.0
A11147,42,25,0,67,0.63,0.37,0.0
A11148,0,5,0,5,0.0,1.0,0.0
A11149,9,9,0,18,0.5,0.5,0.0
A11150,10,5,0,15,0.67,0.33,0.0
A11151,13,11,0,24,0.54,0.46,0.0
A11152,8,5,0,13,0.62,0.38,0.0
A11153,12,15,1,28,0.43,0.54,0.04
A11154,10,12,1,23,0.43,0.52,0.04
A11155,5,17,0,22,0.23,0.77,0.0
A11156,19,8,0,27,0.7,0.3,0.0
A11157,22,39,0,61,0.36,0.64,0.0
A11158,23,16,0,39,0.59,0.41,0.0
A11159,16,24,0,40,0.4,0.6,0.0
A11160,0,6,0,6,0.0,1.0,0.0
A11161,50,32,1,83,0.6,0.39,0.01
A11162,1,3,0,4,0.25,0.75,0.0
A11163,38,37,0,75,0.51,0.49,0.0
A11164,15,17,0,32,0.47,0.53,0.0
A11165,18,13,0,31,0.58,0.42,0.0
A11166,2,4,0,6,0.33,0.67,0.0
A11167,8,5,0,13,0.62,0.38,0.0
A11168,69,23,0,92,0.75,0.25,0.0
A11169,40,27,0,67,0.6,0.4,0.0
A11170,8,11,0,19,0.42,0.58,0.0
A11171,13,19,0,32,0.41,0.59,0.0
A11172,2,1,0,3,0.67,0.33,0.0
A11173,7,11,0,18,0.39,0.61,0.0
A11174,0,2,0,2,0.0,1.0,0.0
A11175,20,15,0,35,0.57,0.43,0.0
A11176,17,5,0,22,0.77,0.23,0.0
A11177,10,11,2,23,0.43,0.48,0.09
A11178,106,44,0,150,0.71,0.29,0.0
A11179,4,5,0,9,0.44,0.56,0.0
A11180,7,26,0,33,0.21,0.79,0.0
A11181,3,2,0,5,0.6,0.4,0.0
A11182,0,49,0,49,0.0,1.0,0.0
A11183,13,7,0,20,0.65,0.35,0.0
A11184,15,48,0,63,0.24,0.76,0.0
A11185,17,12,0,29,0.59,0.41,0.0
A11186,5,12,0,17,0.29,0.71,0.0
A11187,19,23,1,43,0.44,0.53,0.02
A11188,24,13,0,37,0.65,0.35,0.0
A11189,20,7,0,27,0.74,0.26,0.0
A11190,0,5,0,5,0.0,1.0,0.0
A11191,3,0,0,3,1.0,0.0,0.0
A11192,1,4,0,5,0.2,0.8,0.0
A11193,6,17,0,23,0.26,0.74,0.0
A11194,1,9,0,10,0.1,0.9,0.0
A11195,1,4,0,5,0.2,0.8,0.0
A11196,0,2,0,2,0.0,1.0,0.0
A11197,6,13,0,19,0.32,0.68,0.0
A11198,34,15,0,49,0.69,0.31,0.0
A11199,22,45,0,67,0.33,0.67,0.0
A11200,2,5,0,7,0.29,0.71,0.0
A11201,4,12,0,16,0.25,0.75,0.0
A11202,6,11,0,17,0.35,0.65,0.0
A11203,9,9,0,18,0.5,0.5,0.0
A11204,12,29,0,41,0.29,0.71,0.0
A11205,29,16,0,45,0.64,0.36,0.0
A11206,18,33,0,51,0.35,0.65,0.0
A11207,20,23,1,44,0.45,0.52,0.02
A11208,81,31,0,112,0.72,0.28,0.0
A11209,93,58,0,151,0.62,0.38,0.0
A11210,0,1,0,1,0.0,1.0,0.0
A11211,21,8,0,29,0.72,0.28,0.0
A11212,2,3,0,5,0.4,0.6,0.0
A11213,5,8,0,13,0.38,0.62,0.0
A11214,6,4,0,10,0.6,0.4,0.0
A11215,17,18,0,35,0.49,0.51,0.0
A11216,4,8,0,12,0.33,0.67,0.0
A11217,8,10,0,18,0.44,0.56,0.0
A11218,7,6,2,15,0.47,0.4,0.13
A11219,17,3,0,20,0.85,0.15,0.0
A11220,2,2,0,4,0.5,0.5,0.0
A11221,8,12,0,20,0.4,0.6,0.0
A11222,55,19,0,74,0.74,0.26,0.0
A11223,1,5,0,6,0.17,0.83,0.0
A11224,10,10,0,20,0.5,0.5,0.0
A11225,2,6,0,8,0.25,0.75,0.0
A11226,20,16,0,36,0.56,0.44,0.0
A11227,8,10,0,18,0.44,0.56,0.0
A11228,48,12,0,60,0.8,0.2,0.0
A11229,10,15,2,27,0.37,0.56,0.07
A11230,0,5,0,5,0.0,1.0,0.0
A11231,10,21,0,31,0.32,0.68,0.0
A11232,2,2,0,4,0.5,0.5,0.0
A11233,15,21,0,36,0.42,0.58,0.0
A11234,21,18,0,39,0.54,0.46,0.0
A11235,31,19,0,50,0.62,0.38,0.0
A11236,5,35,0,40,0.12,0.88,0.0
A11237,39,20,0,59,0.66,0.34,0.0
A11238,10,5,1,16,0.62,0.31,0.06
A11239,8,3,0,11,0.73,0.27,0.0
A11240,148,32,3,183,0.81,0.17,0.02
A11241,32,13,0,45,0.71,0.29,0.0
A11242,5,7,0,12,0.42,0.58,0.0
A11243,105,35,0,140,0.75,0.25,0.0
A11244,7,9,0,16,0.44,0.56,0.0
A11245,15,14,0,29,0.52,0.48,0.0
A11246,9,8,0,17,0.53,0.47,0.0
A11247,17,22,0,39,0.44,0.56,0.0
A11248,65,30,2,97,0.67,0.31,0.02
A11249,59,32,0,91,0.65,0.35,0.0
A11250,2,11,0,13,0.15,0.85,0.0
A11251,6,13,0,19,0.32,0.68,0.0
A11252,9,12,1,22,0.41,0.55,0.05
A11253,7,8,0,15,0.47,0.53,0.0
A11255,15,7,0,22,0.68,0.32,0.0
A11256,17,8,0,25,0.68,0.32,0.0
A11257,58,22,0,80,0.72,0.28,0.0
A11258,6,6,0,12,0.5,0.5,0.0
A11259,3,5,0,8,0.38,0.62,0.0
A11260,22,21,0,43,0.51,0.49,0.0
A11261,2,13,0,15,0.13,0.87,0.0
A11262,3,5,0,8,0.38,0.62,0.0
A11263,4,3,0,7,0.57,0.43,0.0
A11264,3,5,0,8,0.38,0.62,0.0
A11265,1,0,0,1,1.0,0.0,0.0
A11266,11,18,0,29,0.38,0.62,0.0
A11267,1,0,0,1,1.0,0.0,0.0
A11268,197,49,0,246,0.8,0.2,0.0
A11269,2,11,0,13,0.15,0.85,0.0
A11270,143,202,1,346,0.41,0.58,0.0
A11271,0,1,0,1,0.0,1.0,0.0
A11272,9,21,0,30,0.3,0.7,0.0
A11273,0,4,0,4,0.0,1.0,0.0
A11274,1,2,0,3,0.33,0.67,0.0
A11275,6,5,0,11,0.55,0.45,0.0
A11277,12,7,0,19,0.63,0.37,0.0
A11278,26,16,0,42,0.62,0.38,0.0
A11279,3,2,0,5,0.6,0.4,0.0
A11280,2,26,0,28,0.07,0.93,0.0
A11281,3,4,0,7,0.43,0.57,0.0
A11282,2,10,0,12,0.17,0.83,0.0
A11283,5,6,0,11,0.45,0.55,0.0
A11284,20,18,0,38,0.53,0.47,0.0
A11285,11,38,0,49,0.22,0.78,0.0
A11286,2,7,0,9,0.22,0.78,0.0
A11287,1,2,0,3,0.33,0.67,0.0
A11288,0,6,0,6,0.0,1.0,0.0
A11289,22,16,0,38,0.58,0.42,0.0
A11290,3,7,0,10,0.3,0.7,0.0
A11292,0,2,0,2,0.0,1.0,0.0
A11293,4,15,0,19,0.21,0.79,0.0
A11294,11,12,0,23,0.48,0.52,0.0
A11295,3,2,0,5,0.6,0.4,0.0
A11296,38,7,0,45,0.84,0.16,0.0
A11297,9,12,0,21,0.43,0.57,0.0
A11298,33,30,0,63,0.52,0.48,0.0
A11299,9,3,0,12,0.75,0.25,0.0
A11300,22,10,0,32,0.69,0.31,0.0
A11301,2,2,0,4,0.5,0.5,0.0
A11302,6,12,0,18,0.33,0.67,0.0
A11303,1,4,0,5,0.2,0.8,0.0
A11304,9,7,0,16,0.56,0.44,0.0
A11305,16,7,0,23,0.7,0.3,0.0
A11306,12,5,0,17,0.71,0.29,0.0
A11307,7,10,0,17,0.41,0.59,0.0
A11308,1,23,0,24,0.04,0.96,0.0
A11309,1,3,0,4,0.25,0.75,0.0
A11310,3,3,0,6,0.5,0.5,0.0
A11311,4,5,0,9,0.44,0.56,0.0
A11312,3,5,0,8,0.38,0.62,0.0
A11314,58,32,0,90,0.64,0.36,0.0
A11315,25,29,3,57,0.44,0.51,0.05
A11316,11,5,0,16,0.69,0.31,0.0
A11317,2,8,0,10,0.2,0.8,0.0
A11318,9,16,0,25,0.36,0.64,0.0
A11319,1,7,0,8,0.12,0.88,0.0
A11320,15,15,0,30,0.5,0.5,0.0
A11321,1,0,0,1,1.0,0.0,0.0
A11322,8,18,0,26,0.31,0.69,0.0
A11323,12,8,0,20,0.6,0.4,0.0
A11324,1,1,0,2,0.5,0.5,0.0
A11325,1,5,0,6,0.17,0.83,0.0
A11327,0,2,0,2,0.0,1.0,0.0
A11328,8,1,0,9,0.89,0.11,0.0
A11329,2,3,0,5,0.4,0.6,0.0
A11330,4,3,0,7,0.57,0.43,0.0
A11331,5,12,0,17,0.29,0.71,0.0
A11332,0,4,0,4,0.0,1.0,0.0
A11333,2,5,0,7,0.29,0.71,0.0
A11334,9,18,0,27,0.33,0.67,0.0
A11335,58,21,1,80,0.72,0.26,0.01
A11336,1,5,0,6,0.17,0.83,0.0
A11337,1,6,0,7,0.14,0.86,0.0
A11339,3,4,0,7,0.43,0.57,0.0
A11340,5,2,0,7,0.71,0.29,0.0
A11341,2,1,0,3,0.67,0.33,0.0
A11342,2,0,0,2,1.0,0.0,0.0
A11343,1,2,0,3,0.33,0.67,0.0
A11345,6,3,0,9,0.67,0.33,0.0
A11347,9,19,0,28,0.32,0.68,0.0
A11348,0,1,0,1,0.0,1.0,0.0
A11349,3,1,0,4,0.75,0.25,0.0
A11350,19,26,0,45,0.42,0.58,0.0
A11351,17,17,0,34,0.5,0.5,0.0
A11352,1,0,0,1,1.0,0.0,0.0
A11353,1,2,0,3,0.33,0.67,0.0
A11354,0,3,0,3,0.0,1.0,0.0
A11355,5,8,0,13,0.38,0.62,0.0
A11356,0,6,0,6,0.0,1.0,0.0
A11357,15,5,0,20,0.75,0.25,0.0
A11358,1,8,0,9,0.11,0.89,0.0
A11359,7,11,0,18,0.39,0.61,0.0
A11360,3,7,0,10,0.3,0.7,0.0
A11361,4,26,0,30,0.13,0.87,0.0
A11362,9,9,0,18,0.5,0.5,0.0
A11363,0,1,0,1,0.0,1.0,0.0
A11364,5,7,0,12,0.42,0.58,0.0
A11365,1,5,0,6,0.17,0.83,0.0
A11366,3,11,0,14,0.21,0.79,0.0
A11367,4,8,0,12,0.33,0.67,0.0
A11368,3,2,1,6,0.5,0.33,0.17
A11369,8,3,1,12,0.67,0.25,0.08
A11370,0,2,0,2,0.0,1.0,0.0
A11371,45,14,0,59,0.76,0.24,0.0
A11372,2,4,0,6,0.33,0.67,0.0
A11373,14,10,1,25,0.56,0.4,0.04
A11374,10,20,0,30,0.33,0.67,0.0
A11375,13,13,0,26,0.5,0.5,0.0
A11376,3,3,0,6,0.5,0.5,0.0
A11377,3,7,0,10,0.3,0.7,0.0
A11378,5,12,0,17,0.29,0.71,0.0
A11379,0,1,0,1,0.0,1.0,0.0
A11380,107,36,0,143,0.75,0.25,0.0
A11381,6,2,0,8,0.75,0.25,0.0
A11382,1,3,0,4,0.25,0.75,0.0
A11383,0,3,0,3,0.0,1.0,0.0
A11384,1,3,0,4,0.25,0.75,0.0
A11385,146,42,0,188,0.78,0.22,0.0
A11386,15,12,0,27,0.56,0.44,0.0
A11387,9,9,0,18,0.5,0.5,0.0
A11388,4,11,0,15,0.27,0.73,0.0
A11389,2,14,0,16,0.12,0.88,0.0
A11390,30,14,0,44,0.68,0.32,0.0
A11391,9,1,0,10,0.9,0.1,0.0
A11392,2,8,0,10,0.2,0.8,0.0
A11393,0,7,0,7,0.0,1.0,0.0
A11394,4,8,0,12,0.33,0.67,0.0
A11395,0,14,0,14,0.0,1.0,0.0
A11396,36,69,0,105,0.34,0.66,0.0
A11397,7,8,0,15,0.47,0.53,0.0
A11398,8,4,0,12,0.67,0.33,0.0
A11399,0,10,0,10,0.0,1.0,0.0
A11400,6,11,0,17,0.35,0.65,0.0
A11401,13,12,0,25,0.52,0.48,0.0
A11402,115,195,0,310,0.37,0.63,0.0
A11403,5,27,4,36,0.14,0.75,0.11
A11404,11,6,0,17,0.65,0.35,0.0
A11405,4,5,0,9,0.44,0.56,0.0
A11406,6,2,0,8,0.75,0.25,0.0
A11407,10,7,0,17,0.59,0.41,0.0
A11408,5,22,0,27,0.19,0.81,0.0
A11409,1,16,0,17,0.06,0.94,0.0
A11410,13,12,0,25,0.52,0.48,0.0
A11411,0,1,0,1,0.0,1.0,0.0
A11412,2,8,0,10,0.2,0.8,0.0
A11413,5,9,0,14,0.36,0.64,0.0
A11414,7,7,0,14,0.5,0.5,0.0
A11415,3,3,0,6,0.5,0.5,0.0
A11416,5,5,0,10,0.5,0.5,0.0
A11417,276,379,3,658,0.42,0.58,0.0
A11418,6,10,0,16,0.38,0.62,0.0
A11419,64,20,0,84,0.76,0.24,0.0
A11420,1,19,0,20,0.05,0.95,0.0
A11421,8,11,0,19,0.42,0.58,0.0
A11422,4,13,0,17,0.24,0.76,0.0
A11423,5,6,0,11,0.45,0.55,0.0
A11424,18,23,2,43,0.42,0.53,0.05
A11425,4,6,0,10,0.4,0.6,0.0
A11426,5,2,0,7,0.71,0.29,0.0
A11427,8,6,0,14,0.57,0.43,0.0
A11428,0,2,0,2,0.0,1.0,0.0
A11430,2,3,2,7,0.29,0.43,0.29
A11431,1,2,0,3,0.33,0.67,0.0
A11432,2,7,0,9,0.22,0.78,0.0
A11433,0,2,0,2,0.0,1.0,0.0
A11434,14,22,0,36,0.39,0.61,0.0
A11435,9,8,0,17,0.53,0.47,0.0
A11436,37,12,0,49,0.76,0.24,0.0
A11437,2,5,0,7,0.29,0.71,0.0
A11438,0,4,0,4,0.0,1.0,0.0
A11439,15,29,0,44,0.34,0.66,0.0
A11440,28,10,0,38,0.74,0.26,0.0
A11441,4,11,0,15,0.27,0.73,0.0
A11442,26,17,0,43,0.6,0.4,0.0
A11443,6,3,0,9,0.67,0.33,0.0
A11444,1,1,1,3,0.33,0.33,0.33
A11445,14,21,0,35,0.4,0.6,0.0
A11446,2,2,0,4,0.5,0.5,0.0
A11447,0,5,0,5,0.0,1.0,0.0
A11448,2,4,0,6,0.33,0.67,0.0
A11449,5,2,0,7,0.71,0.29,0.0
A11450,8,10,0,18,0.44,0.56,0.0
A11451,0,5,0,5,0.0,1.0,0.0
A11452,26,21,1,48,0.54,0.44,0.02
A11453,12,12,0,24,0.5,0.5,0.0
A11454,9,11,0,20,0.45,0.55,0.0
A11455,13,12,0,25,0.52,0.48,0.0
A11456,0,3,0,3,0.0,1.0,0.0
A11457,16,5,0,21,0.76,0.24,0.0
A11458,13,15,0,28,0.46,0.54,0.0
A11459,3,8,0,11,0.27,0.73,0.0
A11460,7,22,1,30,0.23,0.73,0.03
A11461,9,3,0,12,0.75,0.25,0.0
A11462,1,3,0,4,0.25,0.75,0.0
A11463,3,12,0,15,0.2,0.8,0.0
A11464,36,109,0,145,0.25,0.75,0.0
A11465,10,8,0,18,0.56,0.44,0.0
A11466,1,8,0,9,0.11,0.89,0.0
A11467,4,14,0,18,0.22,0.78,0.0
A11468,4,12,0,16,0.25,0.75,0.0
A11469,2,5,0,7,0.29,0.71,0.0
A11470,0,3,0,3,0.0,1.0,0.0
A11471,7,10,0,17,0.41,0.59,0.0
A11473,5,2,0,7,0.71,0.29,0.0
A11474,15,11,0,26,0.58,0.42,0.0
A11475,2,4,0,6,0.33,0.67,0.0
A11476,7,8,0,15,0.47,0.53,0.0
A11477,3,6,0,9,0.33,0.67,0.0
A11478,0,4,0,4,0.0,1.0,0.0
A11479,130,232,0,362,0.36,0.64,0.0
A11480,15,6,0,21,0.71,0.29,0.0
A11481,23,18,0,41,0.56,0.44,0.0
A11482,3,3,0,6,0.5,0.5,0.0
A11483,1,2,0,3,0.33,0.67,0.0
A11484,10,15,0,25,0.4,0.6,0.0
A11485,11,23,0,34,0.32,0.68,0.0
A11486,9,3,0,12,0.75,0.25,0.0
A11487,19,16,0,35,0.54,0.46,0.0
A11488,5,5,0,10,0.5,0.5,0.0
A11489,35,16,1,52,0.67,0.31,0.02
A11490,7,14,0,21,0.33,0.67,0.0
A11492,8,1,0,9,0.89,0.11,0.0
A11493,9,4,0,13,0.69,0.31,0.0
A11494,0,1,0,1,0.0,1.0,0.0
A11495,20,10,0,30,0.67,0.33,0.0
A11496,219,264,2,485,0.45,0.54,0.0
A11497,1,3,0,4,0.25,0.75,0.0
A11498,4,11,0,15,0.27,0.73,0.0
A11499,12,5,0,17,0.71,0.29,0.0
A11500,4,3,0,7,0.57,0.43,0.0
A11501,0,8,0,8,0.0,1.0,0.0
A11502,25,24,0,49,0.51,0.49,0.0
A11503,4,6,0,10,0.4,0.6,0.0
A11504,6,5,0,11,0.55,0.45,0.0
A11505,63,18,0,81,0.78,0.22,0.0
A11506,11,4,0,15,0.73,0.27,0.0
A11507,4,7,0,11,0.36,0.64,0.0
A11508,6,8,0,14,0.43,0.57,0.0
A11509,93,41,10,144,0.65,0.28,0.07
A11510,2,10,0,12,0.17,0.83,0.0
A11511,51,31,0,82,0.62,0.38,0.0
A11512,1,2,0,3,0.33,0.67,0.0
A11513,6,6,0,12,0.5,0.5,0.0
A11514,71,38,6,115,0.62,0.33,0.05
A11515,10,9,0,19,0.53,0.47,0.0
A11516,8,8,0,16,0.5,0.5,0.0
A11517,4,5,0,9,0.44,0.56,0.0
A11518,37,5,0,42,0.88,0.12,0.0
A11520,13,20,0,33,0.39,0.61,0.0
A11521,12,15,0,27,0.44,0.56,0.0
A11522,17,6,0,23,0.74,0.26,0.0
A11523,5,13,0,18,0.28,0.72,0.0
A11524,1,9,0,10,0.1,0.9,0.0
A11525,3,6,0,9,0.33,0.67,0.0
A11526,2,7,0,9,0.22,0.78,0.0
A11527,2,4,0,6,0.33,0.67,0.0
A11528,26,22,0,48,0.54,0.46,0.0
A11529,1,1,0,2,0.5,0.5,0.0
A11530,33,7,0,40,0.82,0.17,0.0
A11531,8,11,0,19,0.42,0.58,0.0
A11532,8,18,2,28,0.29,0.64,0.07
A11533,7,15,0,22,0.32,0.68,0.0
A11534,2,2,0,4,0.5,0.5,0.0
A11535,4,2,0,6,0.67,0.33,0.0
A11536,3,11,0,14,0.21,0.79,0.0
A11537,11,15,0,26,0.42,0.58,0.0
A11538,83,16,0,99,0.84,0.16,0.0
A11539,2,5,0,7,0.29,0.71,0.0
A11540,8,17,0,25,0.32,0.68,0.0
A11541,1,2,0,3,0.33,0.67,0.0
A11542,0,2,0,2,0.0,1.0,0.0
A11543,0,1,0,1,0.0,1.0,0.0
A11544,3,4,0,7,0.43,0.57,0.0
A11545,1,6,0,7,0.14,0.86,0.0
A11546,5,11,0,16,0.31,0.69,0.0
A11547,2,3,0,5,0.4,0.6,0.0
A11548,2,6,0,8,0.25,0.75,0.0
A11549,2,3,0,5,0.4,0.6,0.0
A11550,4,5,0,9,0.44,0.56,0.0
A11551,4,3,0,7,0.57,0.43,0.0
A11552,1,3,0,4,0.25,0.75,0.0
A11554,8,8,0,16,0.5,0.5,0.0
A11555,3,3,0,6,0.5,0.5,0.0
A11556,5,10,0,15,0.33,0.67,0.0
A11557,2,2,0,4,0.5,0.5,0.0
A11558,2,4,0,6,0.33,0.67,0.0
A11559,4,5,0,9,0.44,0.56,0.0
A11560,5,5,0,10,0.5,0.5,0.0
A11561,3,4,0,7,0.43,0.57,0.0
A11563,1,2,0,3,0.33,0.67,0.0
A11564,1,0,0,1,1.0,0.0,0.0
A11565,2,5,0,7,0.29,0.71,0.0
A11566,5,7,0,12,0.42,0.58,0.0
A11567,4,8,0,12,0.33,0.67,0.0
A11568,8,10,0,18,0.44,0.56,0.0
A11569,1,1,0,2,0.5,0.5,0.0
A11570,1,3,0,4,0.25,0.75,0.0
A11571,1,1,0,2,0.5,0.5,0.0
A11572,27,42,0,69,0.39,0.61,0.0
A11573,2,2,0,4,0.5,0.5,0.0
A11574,3,2,0,5,0.6,0.4,0.0
A11575,1,1,0,2,0.5,0.5,0.0
A11576,0,2,0,2,0.0,1.0,0.0
A11577,8,5,0,13,0.62,0.38,0.0
A11578,6,5,0,11,0.55,0.45,0.0
A11579,11,4,0,15,0.73,0.27,0.0
A11580,0,2,0,2,0.0,1.0,0.0
A11581,1,0,0,1,1.0,0.0,0.0
A11582,4,9,0,13,0.31,0.69,0.0
A11583,21,4,0,25,0.84,0.16,0.0
A11584,1,3,0,4,0.25,0.75,0.0
A11585,3,2,0,5,0.6,0.4,0.0
A11586,4,5,0,9,0.44,0.56,0.0
A11587,1,1,0,2,0.5,0.5,0.0
A11588,1,2,0,3,0.33,0.67,0.0
A11589,1,8,0,9,0.11,0.89,0.0
A11590,2,1,0,3,0.67,0.33,0.0
A11591,1,3,0,4,0.25,0.75,0.0
A11593,0,3,0,3,0.0,1.0,0.0
A11594,2,3,0,5,0.4,0.6,0.0
A11595,0,1,0,1,0.0,1.0,0.0
A11596,1,1,0,2,0.5,0.5,0.0
A11597,0,14,0,14,0.0,1.0,0.0
A11598,2,5,0,7,0.29,0.71,0.0
A11599,0,1,0,1,0.0,1.0,0.0
A11600,1,8,0,9,0.11,0.89,0.0
A11601,4,4,0,8,0.5,0.5,0.0
A11602,0,2,0,2,0.0,1.0,0.0
A11603,1,9,0,10,0.1,0.9,0.0
A11604,0,5,0,5,0.0,1.0,0.0
A11605,1,2,0,3,0.33,0.67,0.0
A11606,12,41,0,53,0.23,0.77,0.0
A11607,0,1,0,1,0.0,1.0,0.0
A11608,4,4,0,8,0.5,0.5,0.0
A11609,2,1,0,3,0.67,0.33,0.0
A11610,1,4,0,5,0.2,0.8,0.0
A11612,1,3,0,4,0.25,0.75,0.0
A11613,1,1,0,2,0.5,0.5,0.0
A11614,3,1,0,4,0.75,0.25,0.0
A11615,1,6,0,7,0.14,0.86,0.0
A11617,6,7,0,13,0.46,0.54,0.0
A11618,2,7,0,9,0.22,0.78,0.0
A11619,5,13,0,18,0.28,0.72,0.0
A11621,3,11,0,14,0.21,0.79,0.0
A11622,13,28,0,41,0.32,0.68,0.0
A11623,4,9,0,13,0.31,0.69,0.0
A11624,16,20,2,38,0.42,0.53,0.05
A11625,14,26,0,40,0.35,0.65,0.0
A11626,2,4,0,6,0.33,0.67,0.0
A11627,1,1,0,2,0.5,0.5,0.0
A11628,0,5,0,5,0.0,1.0,0.0
A11629,10,4,0,14,0.71,0.29,0.0
A11630,10,1,0,11,0.91,0.09,0.0
A11631,2,2,0,4,0.5,0.5,0.0
A11632,0,2,0,2,0.0,1.0,0.0
A11633,2,10,0,12,0.17,0.83,0.0
A11634,11,12,0,23,0.48,0.52,0.0
A11635,12,17,0,29,0.41,0.59,0.0
A11636,1,0,0,1,1.0,0.0,0.0
A11637,0,1,0,1,0.0,1.0,0.0
A11638,0,3,0,3,0.0,1.0,0.0
A11639,10,10,0,20,0.5,0.5,0.0
A11640,4,6,0,10,0.4,0.6,0.0
A11641,13,31,0,44,0.3,0.7,0.0
A11642,5,6,0,11,0.45,0.55,0.0
A11643,32,10,1,43,0.74,0.23,0.02
A11644,0,3,0,3,0.0,1.0,0.0
A11645,4,12,0,16,0.25,0.75,0.0
A11646,2,7,0,9,0.22,0.78,0.0
A11647,0,4,0,4,0.0,1.0,0.0
A11648,19,15,0,34,0.56,0.44,0.0
A11649,1,5,0,6,0.17,0.83,0.0
A11650,2,10,0,12,0.17,0.83,0.0
A11651,0,1,0,1,0.0,1.0,0.0
A11652,0,5,0,5,0.0,1.0,0.0
A11653,1,4,0,5,0.2,0.8,0.0
A11654,2,3,0,5,0.4,0.6,0.0
A11655,3,4,0,7,0.43,0.57,0.0
A11656,13,6,0,19,0.68,0.32,0.0
A11657,2,0,0,2,1.0,0.0,0.0
A11658,0,2,0,2,0.0,1.0,0.0
A11659,9,6,0,15,0.6,0.4,0.0
A11660,0,7,0,7,0.0,1.0,0.0
A11661,1,1,0,2,0.5,0.5,0.0
A11662,2,3,0,5,0.4,0.6,0.0
A11663,4,1,0,5,0.8,0.2,0.0
A11664,1,6,0,7,0.14,0.86,0.0
A11665,2,2,0,4,0.5,0.5,0.0
A11666,0,2,0,2,0.0,1.0,0.0
A11668,5,23,0,28,0.18,0.82,0.0
A11669,11,17,0,28,0.39,0.61,0.0
A11670,1,6,0,7,0.14,0.86,0.0
A11671,1,2,0,3,0.33,0.67,0.0
A11672,0,2,0,2,0.0,1.0,0.0
A11673,12,5,0,17,0.71,0.29,0.0
A11674,21,13,0,34,0.62,0.38,0.0
A11675,0,1,0,1,0.0,1.0,0.0
A11676,2,1,0,3,0.67,0.33,0.0
A11677,0,1,0,1,0.0,1.0,0.0
A11678,4,7,0,11,0.36,0.64,0.0
A11679,3,26,0,29,0.1,0.9,0.0
A11680,0,2,0,2,0.0,1.0,0.0
A11681,0,4,0,4,0.0,1.0,0.0
A11682,0,1,0,1,0.0,1.0,0.0
A11683,2,1,0,3,0.67,0.33,0.0
A11684,4,5,0,9,0.44,0.56,0.0
A11685,1,0,0,1,1.0,0.0,0.0
A11686,10,4,0,14,0.71,0.29,0.0
A11687,1,14,0,15,0.07,0.93,0.0
A11688,2,1,0,3,0.67,0.33,0.0
A11689,4,7,0,11,0.36,0.64,0.0
A11690,0,1,0,1,0.0,1.0,0.0
A11691,5,6,1,12,0.42,0.5,0.08
A11692,1,1,0,2,0.5,0.5,0.0
A11693,1,2,0,3,0.33,0.67,0.0
A11694,0,1,0,1,0.0,1.0,0.0
A11695,0,1,0,1,0.0,1.0,0.0
A11696,13,11,0,24,0.54,0.46,0.0
A11697,1,8,0,9,0.11,0.89,0.0
A11698,8,19,0,27,0.3,0.7,0.0
A11699,19,9,2,30,0.63,0.3,0.07
A11700,2,4,0,6,0.33,0.67,0.0
A11701,4,5,0,9,0.44,0.56,0.0
A11702,0,3,0,3,0.0,1.0,0.0
A11703,0,6,0,6,0.0,1.0,0.0
A11704,10,9,2,21,0.48,0.43,0.1
A11705,0,2,0,2,0.0,1.0,0.0
A11706,0,1,0,1,0.0,1.0,0.0
A11707,14,15,1,30,0.47,0.5,0.03
A11708,0,3,0,3,0.0,1.0,0.0
A11709,14,17,0,31,0.45,0.55,0.0
A11710,0,4,0,4,0.0,1.0,0.0
A11711,0,2,0,2,0.0,1.0,0.0
A11712,0,2,0,2,0.0,1.0,0.0
A11713,0,1,0,1,0.0,1.0,0.0
A11714,3,4,0,7,0.43,0.57,0.0
A11715,1,4,0,5,0.2,0.8,0.0
A11716,0,5,0,5,0.0,1.0,0.0
A11717,0,2,0,2,0.0,1.0,0.0
A11720,23,34,0,57,0.4,0.6,0.0
A11721,9,19,0,28,0.32,0.68,0.0
A11722,3,4,0,7,0.43,0.57,0.0
A11725,12,14,2,28,0.43,0.5,0.07
A11726,0,1,0,1,0.0,1.0,0.0
A11727,1,3,0,4,0.25,0.75,0.0
A11728,1,4,0,5,0.2,0.8,0.0
A11729,7,3,0,10,0.7,0.3,0.0
A11730,28,23,0,51,0.55,0.45,0.0
A11732,58,17,1,76,0.76,0.22,0.01
A11733,11,14,0,25,0.44,0.56,0.0
A11734,117,29,1,147,0.8,0.2,0.01
A11735,10,29,0,39,0.26,0.74,0.0
A11736,6,10,0,16,0.38,0.62,0.0
A11737,7,27,0,34,0.21,0.79,0.0
A11738,3,5,0,8,0.38,0.62,0.0
A11739,15,3,1,19,0.79,0.16,0.05
A11740,4,5,1,10,0.4,0.5,0.1
A11741,12,15,0,27,0.44,0.56,0.0
A11742,10,6,0,16,0.62,0.38,0.0
A11743,2,2,0,4,0.5,0.5,0.0
A11744,14,14,0,28,0.5,0.5,0.0
A11746,0,3,0,3,0.0,1.0,0.0
A11747,0,2,0,2,0.0,1.0,0.0
A11748,18,21,0,39,0.46,0.54,0.0
A11749,14,3,0,17,0.82,0.18,0.0
A11750,23,19,0,42,0.55,0.45,0.0
A11751,4,6,0,10,0.4,0.6,0.0
A11753,9,5,0,14,0.64,0.36,0.0
A11754,7,8,0,15,0.47,0.53,0.0
A11755,31,20,0,51,0.61,0.39,0.0
A11756,1,8,0,9,0.11,0.89,0.0
A11757,0,2,0,2,0.0,1.0,0.0
A11758,6,17,0,23,0.26,0.74,0.0
A11759,7,4,0,11,0.64,0.36,0.0
A11760,2,2,0,4,0.5,0.5,0.0
A11761,19,18,0,37,0.51,0.49,0.0
A11762,0,6,0,6,0.0,1.0,0.0
A11763,5,11,0,16,0.31,0.69,0.0
A11764,0,1,0,1,0.0,1.0,0.0
A11765,3,5,0,8,0.38,0.62,0.0
A11766,14,38,0,52,0.27,0.73,0.0
A11767,2,4,0,6,0.33,0.67,0.0
A11768,1,1,0,2,0.5,0.5,0.0
A11769,2,0,0,2,1.0,0.0,0.0
A11770,7,2,0,9,0.78,0.22,0.0
A11771,19,19,0,38,0.5,0.5,0.0
A11773,9,8,0,17,0.53,0.47,0.0
A11774,2,11,0,13,0.15,0.85,0.0
A11775,19,16,0,35,0.54,0.46,0.0
A11776,3,5,0,8,0.38,0.62,0.0
A11777,2,5,0,7,0.29,0.71,0.0
A11778,1,1,0,2,0.5,0.5,0.0
A11779,3,3,0,6,0.5,0.5,0.0
A11780,9,9,0,18,0.5,0.5,0.0
A11783,16,8,1,25,0.64,0.32,0.04
A11784,1,6,0,7,0.14,0.86,0.0
A11786,12,7,0,19,0.63,0.37,0.0
A11787,4,19,0,23,0.17,0.83,0.0
A11788,0,3,0,3,0.0,1.0,0.0
A11789,6,4,0,10,0.6,0.4,0.0
A11790,31,8,1,40,0.78,0.2,0.03
A11791,20,4,0,24,0.83,0.17,0.0
A11794,6,5,0,11,0.55,0.45,0.0
A11795,17,11,0,28,0.61,0.39,0.0
A11796,20,19,0,39,0.51,0.49,0.0
A11797,0,2,0,2,0.0,1.0,0.0
A11798,7,3,0,10,0.7,0.3,0.0
A11799,50,19,0,69,0.72,0.28,0.0
A11801,75,18,0,93,0.81,0.19,0.0
A11802,11,8,0,19,0.58,0.42,0.0
A11803,51,8,0,59,0.86,0.14,0.0
A11804,4,3,0,7,0.57,0.43,0.0
A11805,3,6,0,9,0.33,0.67,0.0
A11806,6,11,0,17,0.35,0.65,0.0
A11807,14,22,0,36,0.39,0.61,0.0
A11808,4,7,0,11,0.36,0.64,0.0
A11809,17,1,0,18,0.94,0.06,0.0
A11810,1,2,0,3,0.33,0.67,0.0
A11811,0,2,0,2,0.0,1.0,0.0
A11812,1,0,0,1,1.0,0.0,0.0
A11813,7,5,0,12,0.58,0.42,0.0
A11814,3,0,0,3,1.0,0.0,0.0
A11815,7,4,0,11,0.64,0.36,0.0
A11816,7,3,0,10,0.7,0.3,0.0
A11817,1,1,0,2,0.5,0.5,0.0
A11818,9,6,0,15,0.6,0.4,0.0
A11819,14,2,0,16,0.88,0.12,0.0
A11820,7,5,0,12,0.58,0.42,0.0
A11821,9,16,1,26,0.35,0.62,0.04
A11822,5,28,0,33,0.15,0.85,0.0
A11823,3,4,0,7,0.43,0.57,0.0
A11824,1,17,0,18,0.06,0.94,0.0
A11826,12,30,0,42,0.29,0.71,0.0
A11827,3,9,0,12,0.25,0.75,0.0
A11828,7,5,0,12,0.58,0.42,0.0
A11829,1,0,0,1,1.0,0.0,0.0
A11830,3,11,0,14,0.21,0.79,0.0
A11832,1,1,0,2,0.5,0.5,0.0
A11833,2,0,0,2,1.0,0.0,0.0
A11834,2,16,0,18,0.11,0.89,0.0
A11835,0,1,0,1,0.0,1.0,0.0
A11836,2,1,0,3,0.67,0.33,0.0
A11837,9,4,0,13,0.69,0.31,0.0
A11838,20,20,0,40,0.5,0.5,0.0
A11839,4,2,0,6,0.67,0.33,0.0
A11840,1,5,0,6,0.17,0.83,0.0
A11841,6,8,0,14,0.43,0.57,0.0
A11842,13,2,0,15,0.87,0.13,0.0
A11844,2,1,3,6,0.33,0.17,0.5
A11845,0,3,0,3,0.0,1.0,0.0
A11846,1,6,0,7,0.14,0.86,0.0
A11847,1,2,0,3,0.33,0.67,0.0
A11848,9,12,0,21,0.43,0.57,0.0
A11850,1,3,1,5,0.2,0.6,0.2
A11851,3,2,0,5,0.6,0.4,0.0
A11852,6,3,0,9,0.67,0.33,0.0
A11853,1,2,0,3,0.33,0.67,0.0
A11854,2,3,0,5,0.4,0.6,0.0
A11856,0,1,0,1,0.0,1.0,0.0
A11857,0,1,0,1,0.0,1.0,0.0
A11859,5,4,0,9,0.56,0.44,0.0
A11860,11,4,15,30,0.37,0.13,0.5
A11861,6,2,0,8,0.75,0.25,0.0
A11863,1,2,0,3,0.33,0.67,0.0
A11864,1,4,0,5,0.2,0.8,0.0
A11865,1,6,0,7,0.14,0.86,0.0
A11866,0,4,0,4,0.0,1.0,0.0
A11867,20,17,0,37,0.54,0.46,0.0
A11868,7,16,0,23,0.3,0.7,0.0
A11869,24,18,0,42,0.57,0.43,0.0
A11870,3,1,0,4,0.75,0.25,0.0
A11871,1,0,0,1,1.0,0.0,0.0
A11872,6,3,0,9,0.67,0.33,0.0
A11873,5,2,0,7,0.71,0.29,0.0
A11874,0,3,0,3,0.0,1.0,0.0
A11875,23,9,0,32,0.72,0.28,0.0
A11876,0,1,0,1,0.0,1.0,0.0
A11877,6,10,0,16,0.38,0.62,0.0
A11878,0,6,0,6,0.0,1.0,0.0
A11880,2,6,0,8,0.25,0.75,0.0
A11881,0,1,0,1,0.0,1.0,0.0
A11882,3,3,0,6,0.5,0.5,0.0
A11883,97,24,7,128,0.76,0.19,0.05
A11886,1,0,0,1,1.0,0.0,0.0
A11887,1,0,0,1,1.0,0.0,0.0
A11888,0,1,0,1,0.0,1.0,0.0
A11889,0,1,0,1,0.0,1.0,0.0
A11890,1,2,0,3,0.33,0.67,0.0
A11891,1,0,0,1,1.0,0.0,0.0
A11892,2,0,0,2,1.0,0.0,0.0
A11893,22,17,0,39,0.56,0.44,0.0
A11894,10,15,0,25,0.4,0.6,0.0
A11895,5,3,0,8,0.62,0.38,0.0
A11896,23,17,0,40,0.57,0.42,0.0
A11897,4,3,0,7,0.57,0.43,0.0
A11898,1,4,0,5,0.2,0.8,0.0
A11899,6,7,0,13,0.46,0.54,0.0
A11900,1,3,0,4,0.25,0.75,0.0
A11901,3,3,0,6,0.5,0.5,0.0
A11902,9,9,1,19,0.47,0.47,0.05
A11903,2,5,0,7,0.29,0.71,0.0
A11904,9,9,0,18,0.5,0.5,0.0
A11905,3,1,0,4,0.75,0.25,0.0
A11906,36,17,0,53,0.68,0.32,0.0
A11908,0,2,0,2,0.0,1.0,0.0
A11909,9,16,0,25,0.36,0.64,0.0
A11910,37,13,0,50,0.74,0.26,0.0
A11913,0,3,0,3,0.0,1.0,0.0
A11914,1,0,0,1,1.0,0.0,0.0
A11915,141,20,0,161,0.88,0.12,0.0
A11916,10,4,9,23,0.43,0.17,0.39
A11917,6,13,0,19,0.32,0.68,0.0
A11920,5,2,0,7,0.71,0.29,0.0
A11922,3,4,0,7,0.43,0.57,0.0
A11923,0,3,0,3,0.0,1.0,0.0
A11924,5,6,0,11,0.45,0.55,0.0
A11925,16,24,0,40,0.4,0.6,0.0
A11926,4,3,0,7,0.57,0.43,0.0
A11927,28,21,0,49,0.57,0.43,0.0
A11928,5,2,0,7,0.71,0.29,0.0
A11929,31,38,0,69,0.45,0.55,0.0
A11930,20,3,0,23,0.87,0.13,0.0
A11931,2,0,0,2,1.0,0.0,0.0
A11932,6,2,0,8,0.75,0.25,0.0
A11933,18,36,0,54,0.33,0.67,0.0
A11934,3,6,0,9,0.33,0.67,0.0
A11935,38,7,7,52,0.73,0.13,0.13
A11936,42,30,0,72,0.58,0.42,0.0
A11937,0,1,0,1,0.0,1.0,0.0
A11938,14,10,0,24,0.58,0.42,0.0
A11939,0,7,0,7,0.0,1.0,0.0
A11940,2,3,0,5,0.4,0.6,0.0
A11941,21,4,0,25,0.84,0.16,0.0
A11942,11,27,0,38,0.29,0.71,0.0
A11943,2,3,0,5,0.4,0.6,0.0
A11944,2,6,0,8,0.25,0.75,0.0
A11945,4,20,0,24,0.17,0.83,0.0
A11946,3,2,0,5,0.6,0.4,0.0
A11947,1,2,0,3,0.33,0.67,0.0
A11948,3,8,0,11,0.27,0.73,0.0
A11949,1,0,0,1,1.0,0.0,0.0
A11950,3,6,0,9,0.33,0.67,0.0
A11951,1,0,0,1,1.0,0.0,0.0
A11952,10,10,0,20,0.5,0.5,0.0
A11953,0,1,0,1,0.0,1.0,0.0
A11954,1,4,0,5,0.2,0.8,0.0
A11956,0,4,0,4,0.0,1.0,0.0
A11957,37,39,9,85,0.44,0.46,0.11
A11958,9,13,0,22,0.41,0.59,0.0
A11959,1,6,0,7,0.14,0.86,0.0
A11960,2,1,0,3,0.67,0.33,0.0
A11961,4,6,0,10,0.4,0.6,0.0
A11962,0,2,0,2,0.0,1.0,0.0
A11963,0,1,0,1,0.0,1.0,0.0
A11964,1,0,0,1,1.0,0.0,0.0
A11968,0,1,0,1,0.0,1.0,0.0
A11969,7,16,0,23,0.3,0.7,0.0
A11970,1,9,0,10,0.1,0.9,0.0
A11971,3,3,0,6,0.5,0.5,0.0
A11972,13,9,0,22,0.59,0.41,0.0
A11973,2,6,0,8,0.25,0.75,0.0
A11975,0,1,0,1,0.0,1.0,0.0
A11977,1,2,0,3,0.33,0.67,0.0
A11978,8,1,0,9,0.89,0.11,0.0
A11979,4,3,0,7,0.57,0.43,0.0
A11980,8,5,0,13,0.62,0.38,0.0
A11981,5,5,0,10,0.5,0.5,0.0
A11982,0,6,0,6,0.0,1.0,0.0
A11984,9,17,0,26,0.35,0.65,0.0
A11985,3,2,0,5,0.6,0.4,0.0
A11986,15,32,0,47,0.32,0.68,0.0
A11987,6,11,0,17,0.35,0.65,0.0
A11988,4,12,0,16,0.25,0.75,0.0
A11989,0,1,0,1,0.0,1.0,0.0
A11992,2,7,1,10,0.2,0.7,0.1
A11993,7,10,0,17,0.41,0.59,0.0
A11994,0,1,0,1,0.0,1.0,0.0
A11995,2,2,0,4,0.5,0.5,0.0
A11996,1,0,0,1,1.0,0.0,0.0
A11997,1,0,0,1,1.0,0.0,0.0
A11998,0,2,0,2,0.0,1.0,0.0
A11999,4,10,0,14,0.29,0.71,0.0
A12000,0,2,0,2,0.0,1.0,0.0
A12001,10,10,0,20,0.5,0.5,0.0
A12005,0,4,0,4,0.0,1.0,0.0
A12008,0,1,0,1,0.0,1.0,0.0
A12009,3,3,0,6,0.5,0.5,0.0
A12011,1,1,0,2,0.5,0.5,0.0
A12012,2,2,0,4,0.5,0.5,0.0
A12013,1,4,0,5,0.2,0.8,0.0
A12015,19,10,0,29,0.66,0.34,0.0
A12016,17,15,0,32,0.53,0.47,0.0
A12017,2,3,0,5,0.4,0.6,0.0
A12018,2,5,0,7,0.29,0.71,0.0
A12019,2,2,0,4,0.5,0.5,0.0
A12020,0,1,0,1,0.0,1.0,0.0
A12021,0,2,0,2,0.0,1.0,0.0
A12022,0,3,0,3,0.0,1.0,0.0
A12023,19,13,0,32,0.59,0.41,0.0
A12024,11,2,0,13,0.85,0.15,0.0
A12026,0,2,0,2,0.0,1.0,0.0
A12027,3,18,0,21,0.14,0.86,0.0
A12028,1,6,0,7,0.14,0.86,0.0
A12029,1,3,0,4,0.25,0.75,0.0
A12030,0,1,0,1,0.0,1.0,0.0
A12032,2,0,0,2,1.0,0.0,0.0
A12034,50,20,1,71,0.7,0.28,0.01
A12035,0,0,3,3,0.0,0.0,1.0
A12036,7,3,0,10,0.7,0.3,0.0
A12037,0,1,0,1,0.0,1.0,0.0
A12038,36,16,0,52,0.69,0.31,0.0
A12039,1,1,0,2,0.5,0.5,0.0
A12041,14,5,0,19,0.74,0.26,0.0
A12042,2,5,0,7,0.29,0.71,0.0
A12043,0,9,0,9,0.0,1.0,0.0
A12048,9,9,0,18,0.5,0.5,0.0
A12049,1,4,0,5,0.2,0.8,0.0
A12050,2,1,0,3,0.67,0.33,0.0
A12052,1,4,0,5,0.2,0.8,0.0
A12053,1,0,0,1,1.0,0.0,0.0
A12054,6,13,0,19,0.32,0.68,0.0
A12056,0,9,0,9,0.0,1.0,0.0
A12057,1,0,0,1,1.0,0.0,0.0
A12058,8,4,0,12,0.67,0.33,0.0
A12059,3,1,0,4,0.75,0.25,0.0
A12060,0,2,0,2,0.0,1.0,0.0
A12062,28,14,0,42,0.67,0.33,0.0
A12063,1,3,0,4,0.25,0.75,0.0
A12066,16,7,0,23,0.7,0.3,0.0
A12067,4,2,0,6,0.67,0.33,0.0
A12069,0,1,0,1,0.0,1.0,0.0
A12070,5,5,0,10,0.5,0.5,0.0
A12071,34,16,0,50,0.68,0.32,0.0
A12072,2,3,0,5,0.4,0.6,0.0
A12073,3,1,0,4,0.75,0.25,0.0
A12074,3,2,0,5,0.6,0.4,0.0
A12075,4,6,0,10,0.4,0.6,0.0
A12076,1,1,0,2,0.5,0.5,0.0
A12077,3,9,0,12,0.25,0.75,0.0
A12079,0,1,0,1,0.0,1.0,0.0
A12080,3,6,0,9,0.33,0.67,0.0
A12081,3,2,0,5,0.6,0.4,0.0
A12082,5,1,0,6,0.83,0.17,0.0
A12083,7,5,0,12,0.58,0.42,0.0
A12084,0,3,0,3,0.0,1.0,0.0
A12085,0,1,0,1,0.0,1.0,0.0
A12086,13,10,0,23,0.57,0.43,0.0
A12087,1,1,0,2,0.5,0.5,0.0
A12088,9,10,0,19,0.47,0.53,0.0
A12089,2,9,0,11,0.18,0.82,0.0
A12090,4,1,0,5,0.8,0.2,0.0
A12091,1,0,0,1,1.0,0.0,0.0
A12092,22,3,0,25,0.88,0.12,0.0
A12093,0,1,0,1,0.0,1.0,0.0
A12094,2,2,0,4,0.5,0.5,0.0
A12095,1,3,0,4,0.25,0.75,0.0
A12097,0,2,0,2,0.0,1.0,0.0
A12100,1,2,0,3,0.33,0.67,0.0
A12101,0,3,0,3,0.0,1.0,0.0
A12102,1,1,0,2,0.5,0.5,0.0
A12103,1,1,0,2,0.5,0.5,0.0
A12104,0,2,0,2,0.0,1.0,0.0
A12105,0,5,0,5,0.0,1.0,0.0
A12106,29,14,1,44,0.66,0.32,0.02
A12110,1,2,0,3,0.33,0.67,0.0
A12111,1,0,0,1,1.0,0.0,0.0
A12112,2,2,0,4,0.5,0.5,0.0
A12113,0,1,0,1,0.0,1.0,0.0
A12114,6,6,0,12,0.5,0.5,0.0
A12115,0,1,0,1,0.0,1.0,0.0
A12116,1,5,0,6,0.17,0.83,0.0
A12117,11,10,0,21,0.52,0.48,0.0
A12118,13,8,0,21,0.62,0.38,0.0
A12119,5,6,0,11,0.45,0.55,0.0
A12120,16,8,0,24,0.67,0.33,0.0
A12121,6,2,0,8,0.75,0.25,0.0
A12122,1,1,0,2,0.5,0.5,0.0
A12123,2,5,0,7,0.29,0.71,0.0
A12124,4,10,0,14,0.29,0.71,0.0
A12125,1,2,0,3,0.33,0.67,0.0
A12126,0,3,0,3,0.0,1.0,0.0
A12127,1,12,0,13,0.08,0.92,0.0
A12128,0,1,0,1,0.0,1.0,0.0
A12129,0,1,0,1,0.0,1.0,0.0
A12130,0,4,0,4,0.0,1.0,0.0
A12131,0,2,0,2,0.0,1.0,0.0
A12132,3,3,0,6,0.5,0.5,0.0
A12133,1,1,0,2,0.5,0.5,0.0
A12134,0,1,0,1,0.0,1.0,0.0
A12135,2,1,0,3,0.67,0.33,0.0
A12136,3,2,0,5,0.6,0.4,0.0
A12137,4,8,0,12,0.33,0.67,0.0
A12138,0,6,0,6,0.0,1.0,0.0
A12139,2,3,0,5,0.4,0.6,0.0
A12140,3,5,0,8,0.38,0.62,0.0
A12141,4,14,0,18,0.22,0.78,0.0
A12142,7,7,0,14,0.5,0.5,0.0
A12143,8,5,1,14,0.57,0.36,0.07
A12145,26,8,0,34,0.76,0.24,0.0
A12147,0,1,0,1,0.0,1.0,0.0
A12148,2,1,0,3,0.67,0.33,0.0
A12149,1,2,0,3,0.33,0.67,0.0
A12150,1,14,0,15,0.07,0.93,0.0
A12151,4,3,0,7,0.57,0.43,0.0
A12152,1,8,0,9,0.11,0.89,0.0
A12153,5,3,0,8,0.62,0.38,0.0
A12154,3,2,0,5,0.6,0.4,0.0
A12155,5,4,0,9,0.56,0.44,0.0
A12156,0,2,0,2,0.0,1.0,0.0
A12157,1,3,0,4,0.25,0.75,0.0
A12158,1,0,0,1,1.0,0.0,0.0
A12159,1,2,0,3,0.33,0.67,0.0
A12160,4,4,0,8,0.5,0.5,0.0
A12161,25,5,0,30,0.83,0.17,0.0
A12162,9,1,0,10,0.9,0.1,0.0
A12163,4,5,0,9,0.44,0.56,0.0
A12164,1,1,0,2,0.5,0.5,0.0
A12165,4,3,0,7,0.57,0.43,0.0
A12166,1,1,0,2,0.5,0.5,0.0
A12167,0,1,0,1,0.0,1.0,0.0
A12168,2,1,0,3,0.67,0.33,0.0
A12169,3,3,0,6,0.5,0.5,0.0
A12170,27,6,0,33,0.82,0.18,0.0
A12172,3,3,0,6,0.5,0.5,0.0
A12173,0,1,0,1,0.0,1.0,0.0
A12174,3,1,0,4,0.75,0.25,0.0
A12175,0,1,0,1,0.0,1.0,0.0
A12176,46,15,0,61,0.75,0.25,0.0
A12177,0,1,0,1,0.0,1.0,0.0
A12178,28,25,0,53,0.53,0.47,0.0
A12179,1,0,0,1,1.0,0.0,0.0
A12181,1,0,0,1,1.0,0.0,0.0
A12182,2,3,0,5,0.4,0.6,0.0
A12183,2,6,0,8,0.25,0.75,0.0
A12185,16,10,6,32,0.5,0.31,0.19
A12186,5,9,0,14,0.36,0.64,0.0
A12187,1,1,0,2,0.5,0.5,0.0
A12188,1,3,0,4,0.25,0.75,0.0
A12189,1,1,0,2,0.5,0.5,0.0
A12192,0,5,0,5,0.0,1.0,0.0
A12193,0,1,0,1,0.0,1.0,0.0
A12194,3,6,0,9,0.33,0.67,0.0
A12195,5,3,0,8,0.62,0.38,0.0
A12196,36,23,11,70,0.51,0.33,0.16
A12198,2,0,0,2,1.0,0.0,0.0
A12199,1,1,0,2,0.5,0.5,0.0
A12200,5,3,0,8,0.62,0.38,0.0
A12202,0,1,0,1,0.0,1.0,0.0
A12203,3,6,0,9,0.33,0.67,0.0
A12206,1,2,0,3,0.33,0.67,0.0
A12208,0,4,0,4,0.0,1.0,0.0
A12209,0,6,0,6,0.0,1.0,0.0
A12210,0,3,0,3,0.0,1.0,0.0
A12211,1,1,0,2,0.5,0.5,0.0
A12213,1,1,0,2,0.5,0.5,0.0
A12217,1,7,0,8,0.12,0.88,0.0
A12218,0,6,0,6,0.0,1.0,0.0
A12219,0,3,0,3,0.0,1.0,0.0
A12220,0,1,0,1,0.0,1.0,0.0
A12221,9,5,0,14,0.64,0.36,0.0
A12223,0,1,0,1,0.0,1.0,0.0
A12224,5,3,0,8,0.62,0.38,0.0
A12229,0,1,0,1,0.0,1.0,0.0
A12230,1,3,0,4,0.25,0.75,0.0
A12231,0,7,0,7,0.0,1.0,0.0
A12232,1,1,0,2,0.5,0.5,0.0
A12233,2,3,0,5,0.4,0.6,0.0
A12234,12,5,0,17,0.71,0.29,0.0
A12235,24,8,0,32,0.75,0.25,0.0
A12236,2,3,0,5,0.4,0.6,0.0
A12237,0,1,0,1,0.0,1.0,0.0
A12240,0,5,0,5,0.0,1.0,0.0
A12243,4,7,0,11,0.36,0.64,0.0
A12244,12,6,0,18,0.67,0.33,0.0
A12245,0,1,0,1,0.0,1.0,0.0
A12246,1,4,0,5,0.2,0.8,0.0
A12247,5,3,0,8,0.62,0.38,0.0
A12249,0,1,0,1,0.0,1.0,0.0
A12250,1,1,0,2,0.5,0.5,0.0
A12251,7,33,0,40,0.17,0.82,0.0
A12252,4,9,0,13,0.31,0.69,0.0
A12253,0,1,0,1,0.0,1.0,0.0
A12255,5,5,0,10,0.5,0.5,0.0
A12257,0,1,0,1,0.0,1.0,0.0
A12258,2,7,0,9,0.22,0.78,0.0
A12259,0,4,0,4,0.0,1.0,0.0
A12260,5,9,0,14,0.36,0.64,0.0
A12261,1,6,0,7,0.14,0.86,0.0
A12262,0,1,0,1,0.0,1.0,0.0
A12263,0,1,0,1,0.0,1.0,0.0
A12264,0,2,0,2,0.0,1.0,0.0
A12265,0,5,0,5,0.0,1.0,0.0
A12267,7,9,0,16,0.44,0.56,0.0
A12269,22,6,0,28,0.79,0.21,0.0
A12270,2,5,0,7,0.29,0.71,0.0
A12271,0,8,0,8,0.0,1.0,0.0
A12272,1,7,0,8,0.12,0.88,0.0
A12273,2,2,0,4,0.5,0.5,0.0
A12275,7,21,0,28,0.25,0.75,0.0
A12278,0,2,0,2,0.0,1.0,0.0
A12280,1,0,0,1,1.0,0.0,0.0
A12281,0,3,0,3,0.0,1.0,0.0
A12282,43,26,0,69,0.62,0.38,0.0
A12283,2,4,0,6,0.33,0.67,0.0
A12284,1,5,0,6,0.17,0.83,0.0
A12285,5,4,0,9,0.56,0.44,0.0
A12286,3,2,0,5,0.6,0.4,0.0
A12287,5,5,0,10,0.5,0.5,0.0
A12288,3,3,0,6,0.5,0.5,0.0
A12289,45,14,0,59,0.76,0.24,0.0
A12290,0,1,0,1,0.0,1.0,0.0
A12291,23,5,0,28,0.82,0.18,0.0
A12293,4,1,0,5,0.8,0.2,0.0
A12294,36,51,0,87,0.41,0.59,0.0
A12295,7,4,0,11,0.64,0.36,0.0
A12296,23,3,0,26,0.88,0.12,0.0
A12298,1,3,0,4,0.25,0.75,0.0
A12299,6,7,0,13,0.46,0.54,0.0
A12300,9,11,0,20,0.45,0.55,0.0
A12301,11,2,0,13,0.85,0.15,0.0
A12302,8,4,0,12,0.67,0.33,0.0
A12304,36,10,0,46,0.78,0.22,0.0
A12305,2,2,0,4,0.5,0.5,0.0
A12306,2,17,0,19,0.11,0.89,0.0
A12307,0,4,0,4,0.0,1.0,0.0
A12309,4,7,0,11,0.36,0.64,0.0
A12310,1,3,0,4,0.25,0.75,0.0
A12313,2,2,0,4,0.5,0.5,0.0
A12314,2,5,0,7,0.29,0.71,0.0
A12315,2,2,0,4,0.5,0.5,0.0
A12316,1,5,0,6,0.17,0.83,0.0
A12317,8,10,0,18,0.44,0.56,0.0
A12318,1,2,0,3,0.33,0.67,0.0
A12320,4,7,0,11,0.36,0.64,0.0
A12321,1,1,0,2,0.5,0.5,0.0
A12322,3,2,0,5,0.6,0.4,0.0
A12323,12,14,1,27,0.44,0.52,0.04
A12326,0,9,1,10,0.0,0.9,0.1
A12327,65,20,0,85,0.76,0.24,0.0
A12328,11,16,0,27,0.41,0.59,0.0
A12329,31,13,0,44,0.7,0.3,0.0
A12335,1,0,0,1,1.0,0.0,0.0
A12336,7,7,0,14,0.5,0.5,0.0
A12337,0,7,1,8,0.0,0.88,0.12
A12343,1,2,0,3,0.33,0.67,0.0
A12345,11,24,1,36,0.31,0.67,0.03
A12346,79,36,0,115,0.69,0.31,0.0
A12347,0,2,0,2,0.0,1.0,0.0
A12348,1,5,0,6,0.17,0.83,0.0
A12349,9,8,2,19,0.47,0.42,0.11
A12351,0,1,0,1,0.0,1.0,0.0
A12352,0,2,0,2,0.0,1.0,0.0
A12353,3,10,0,13,0.23,0.77,0.0
A12354,1,3,0,4,0.25,0.75,0.0
A12355,0,2,0,2,0.0,1.0,0.0
A12356,23,18,0,41,0.56,0.44,0.0
A12357,0,1,0,1,0.0,1.0,0.0
A12358,1,4,0,5,0.2,0.8,0.0
A12359,3,2,0,5,0.6,0.4,0.0
A12360,0,3,0,3,0.0,1.0,0.0
A12361,0,2,0,2,0.0,1.0,0.0
A12362,1,5,0,6,0.17,0.83,0.0
A12363,1,11,0,12,0.08,0.92,0.0
A12364,1,4,0,5,0.2,0.8,0.0
A12365,0,6,0,6,0.0,1.0,0.0
A12366,15,14,0,29,0.52,0.48,0.0
A12367,6,16,1,23,0.26,0.7,0.04
A12368,3,2,0,5,0.6,0.4,0.0
A12370,0,2,0,2,0.0,1.0,0.0
A12371,0,2,0,2,0.0,1.0,0.0
A12372,68,100,0,168,0.4,0.6,0.0
A12373,21,10,0,31,0.68,0.32,0.0
A12374,4,4,0,8,0.5,0.5,0.0
A12375,6,8,0,14,0.43,0.57,0.0
A12376,4,3,0,7,0.57,0.43,0.0
A12378,1,2,0,3,0.33,0.67,0.0
A12379,3,1,0,4,0.75,0.25,0.0
A12380,3,14,0,17,0.18,0.82,0.0
A12381,0,3,0,3,0.0,1.0,0.0
A12382,1,5,0,6,0.17,0.83,0.0
A12383,1,3,0,4,0.25,0.75,0.0
A12384,12,9,5,26,0.46,0.35,0.19
A12385,1,3,0,4,0.25,0.75,0.0
A12388,2,8,0,10,0.2,0.8,0.0
A12389,0,2,0,2,0.0,1.0,0.0
A12390,8,8,0,16,0.5,0.5,0.0
A12391,4,5,0,9,0.44,0.56,0.0
A12393,9,0,0,9,1.0,0.0,0.0
A12394,8,7,0,15,0.53,0.47,0.0
A12395,4,6,1,11,0.36,0.55,0.09
A12396,7,5,0,12,0.58,0.42,0.0
A12397,2,3,0,5,0.4,0.6,0.0
A12398,0,1,0,1,0.0,1.0,0.0
A12399,3,1,0,4,0.75,0.25,0.0
A12400,2,3,0,5,0.4,0.6,0.0
A12401,1,1,0,2,0.5,0.5,0.0
A12402,4,1,0,5,0.8,0.2,0.0
A12403,7,5,3,15,0.47,0.33,0.2
A12404,11,5,0,16,0.69,0.31,0.0
A12406,3,1,0,4,0.75,0.25,0.0
A12407,0,4,0,4,0.0,1.0,0.0
A12408,9,6,1,16,0.56,0.38,0.06
A12409,12,1,2,15,0.8,0.07,0.13
A12411,112,32,0,144,0.78,0.22,0.0
A12414,28,13,0,41,0.68,0.32,0.0
A12415,1,1,0,2,0.5,0.5,0.0
A12416,3,5,0,8,0.38,0.62,0.0
A12417,3,3,0,6,0.5,0.5,0.0
A12418,1,1,0,2,0.5,0.5,0.0
A12420,4,2,0,6,0.67,0.33,0.0
A12421,1,6,0,7,0.14,0.86,0.0
A12422,2,7,0,9,0.22,0.78,0.0
A12423,1,1,0,2,0.5,0.5,0.0
A12425,0,6,0,6,0.0,1.0,0.0
A12426,7,1,0,8,0.88,0.12,0.0
A12427,1,3,0,4,0.25,0.75,0.0
A12428,0,1,0,1,0.0,1.0,0.0
A12431,0,1,0,1,0.0,1.0,0.0
A12433,1,0,0,1,1.0,0.0,0.0
A12434,3,1,0,4,0.75,0.25,0.0
A12435,3,6,0,9,0.33,0.67,0.0
A12436,0,2,0,2,0.0,1.0,0.0
A12437,0,1,0,1,0.0,1.0,0.0
A12438,0,1,0,1,0.0,1.0,0.0
A12441,1,0,0,1,1.0,0.0,0.0
A12442,1,5,1,7,0.14,0.71,0.14
A12445,0,2,0,2,0.0,1.0,0.0
A12447,0,2,0,2,0.0,1.0,0.0
A12449,1,1,0,2,0.5,0.5,0.0
A12450,1,3,0,4,0.25,0.75,0.0
A12451,0,2,0,2,0.0,1.0,0.0
A12452,8,1,0,9,0.89,0.11,0.0
A12453,1,3,0,4,0.25,0.75,0.0
A12457,5,3,0,8,0.62,0.38,0.0
A12458,3,3,0,6,0.5,0.5,0.0
A12459,1,1,0,2,0.5,0.5,0.0
A12460,0,7,0,7,0.0,1.0,0.0
A12462,5,5,0,10,0.5,0.5,0.0
A12463,4,4,0,8,0.5,0.5,0.0
A12464,20,7,0,27,0.74,0.26,0.0
A12465,9,6,0,15,0.6,0.4,0.0
A12466,8,3,0,11,0.73,0.27,0.0
A12468,0,1,0,1,0.0,1.0,0.0
A12469,0,4,0,4,0.0,1.0,0.0
A12470,1,1,0,2,0.5,0.5,0.0
A12471,10,17,1,28,0.36,0.61,0.04
A12473,1,5,0,6,0.17,0.83,0.0
A12476,0,3,0,3,0.0,1.0,0.0
A12477,9,4,0,13,0.69,0.31,0.0
A12479,0,1,1,2,0.0,0.5,0.5
A12480,0,1,0,1,0.0,1.0,0.0
A12481,0,3,0,3,0.0,1.0,0.0
A12482,0,1,0,1,0.0,1.0,0.0
A12483,0,2,0,2,0.0,1.0,0.0
A12484,3,5,0,8,0.38,0.62,0.0
A12488,0,5,0,5,0.0,1.0,0.0
A12489,5,7,0,12,0.42,0.58,0.0
A12490,0,5,0,5,0.0,1.0,0.0
A12491,16,8,0,24,0.67,0.33,0.0
A12493,0,2,0,2,0.0,1.0,0.0
A12494,1,1,0,2,0.5,0.5,0.0
A12495,1,5,0,6,0.17,0.83,0.0
A12496,1,2,0,3,0.33,0.67,0.0
A12499,11,1,0,12,0.92,0.08,0.0
A12500,1,2,0,3,0.33,0.67,0.0
A12501,4,6,0,10,0.4,0.6,0.0
A12502,18,27,0,45,0.4,0.6,0.0
A12503,0,3,0,3,0.0,1.0,0.0
A12504,1,0,0,1,1.0,0.0,0.0
A12505,2,6,0,8,0.25,0.75,0.0
A12507,0,1,0,1,0.0,1.0,0.0
A12509,6,12,3,21,0.29,0.57,0.14
A12510,5,6,0,11,0.45,0.55,0.0
A12511,0,1,0,1,0.0,1.0,0.0
A12512,1,1,0,2,0.5,0.5,0.0
A12513,1,2,0,3,0.33,0.67,0.0
A12514,13,16,0,29,0.45,0.55,0.0
A12515,2,14,0,16,0.12,0.88,0.0
A12516,0,11,0,11,0.0,1.0,0.0
A12517,8,11,0,19,0.42,0.58,0.0
A12518,0,1,0,1,0.0,1.0,0.0
A12520,2,4,0,6,0.33,0.67,0.0
A12521,14,13,1,28,0.5,0.46,0.04
A12522,29,9,0,38,0.76,0.24,0.0
A12523,2,2,0,4,0.5,0.5,0.0
A12524,2,2,0,4,0.5,0.5,0.0
A12525,8,7,0,15,0.53,0.47,0.0
A12526,0,4,0,4,0.0,1.0,0.0
A12527,0,3,0,3,0.0,1.0,0.0
A12528,2,2,0,4,0.5,0.5,0.0
A12529,14,15,2,31,0.45,0.48,0.06
A12530,3,2,1,6,0.5,0.33,0.17
A12531,3,3,0,6,0.5,0.5,0.0
A12532,10,10,0,20,0.5,0.5,0.0
A12533,1,6,0,7,0.14,0.86,0.0
A12534,10,6,0,16,0.62,0.38,0.0
A12535,2,3,0,5,0.4,0.6,0.0
A12536,6,5,0,11,0.55,0.45,0.0
A12537,2,3,0,5,0.4,0.6,0.0
A12538,3,2,0,5,0.6,0.4,0.0
A12539,0,2,0,2,0.0,1.0,0.0
A12540,10,10,0,20,0.5,0.5,0.0
A12541,0,2,0,2,0.0,1.0,0.0
A12542,4,6,0,10,0.4,0.6,0.0
A12544,0,3,0,3,0.0,1.0,0.0
A12545,0,1,0,1,0.0,1.0,0.0
A12547,2,0,0,2,1.0,0.0,0.0
A12548,7,5,0,12,0.58,0.42,0.0
A12549,1,2,0,3,0.33,0.67,0.0
A12550,1,0,1,2,0.5,0.0,0.5
A12552,27,16,0,43,0.63,0.37,0.0
A12553,3,1,0,4,0.75,0.25,0.0
A12555,10,5,3,18,0.56,0.28,0.17
A12556,4,8,0,12,0.33,0.67,0.0
A12557,7,14,0,21,0.33,0.67,0.0
A12558,3,7,0,10,0.3,0.7,0.0
A12559,30,20,0,50,0.6,0.4,0.0
A12560,2,0,0,2,1.0,0.0,0.0
A12562,0,2,0,2,0.0,1.0,0.0
A12563,0,12,0,12,0.0,1.0,0.0
A12564,3,2,0,5,0.6,0.4,0.0
A12565,0,3,0,3,0.0,1.0,0.0
A12566,0,1,0,1,0.0,1.0,0.0
A12567,0,7,0,7,0.0,1.0,0.0
A12568,0,1,0,1,0.0,1.0,0.0
A12571,4,16,0,20,0.2,0.8,0.0
A12572,0,1,0,1,0.0,1.0,0.0
A12573,2,23,0,25,0.08,0.92,0.0
A12574,1,2,0,3,0.33,0.67,0.0
A12575,6,6,0,12,0.5,0.5,0.0
A12577,11,6,0,17,0.65,0.35,0.0
A12578,3,3,0,6,0.5,0.5,0.0
A12579,5,2,0,7,0.71,0.29,0.0
A12580,6,12,0,18,0.33,0.67,0.0
A12581,1,12,0,13,0.08,0.92,0.0
A12583,0,5,0,5,0.0,1.0,0.0
A12584,3,7,0,10,0.3,0.7,0.0
A12585,16,11,0,27,0.59,0.41,0.0
A12586,0,1,0,1,0.0,1.0,0.0
A12587,3,17,1,21,0.14,0.81,0.05
A12588,0,3,0,3,0.0,1.0,0.0
A12589,0,1,0,1,0.0,1.0,0.0
A12590,1,5,0,6,0.17,0.83,0.0
A12591,0,1,0,1,0.0,1.0,0.0
A12592,0,1,0,1,0.0,1.0,0.0
A12593,0,4,0,4,0.0,1.0,0.0
A12594,13,11,0,24,0.54,0.46,0.0
A12595,2,1,0,3,0.67,0.33,0.0
A12596,12,6,0,18,0.67,0.33,0.0
A12597,0,2,0,2,0.0,1.0,0.0
A12598,0,3,0,3,0.0,1.0,0.0
A12601,1,3,0,4,0.25,0.75,0.0
A12602,1,3,0,4,0.25,0.75,0.0
A12603,0,16,0,16,0.0,1.0,0.0
A12604,2,0,0,2,1.0,0.0,0.0
A12605,3,10,0,13,0.23,0.77,0.0
A12606,2,11,0,13,0.15,0.85,0.0
A12608,0,3,0,3,0.0,1.0,0.0
A12609,18,8,0,26,0.69,0.31,0.0
A12610,4,6,0,10,0.4,0.6,0.0
A12612,0,1,0,1,0.0,1.0,0.0
A12613,0,1,0,1,0.0,1.0,0.0
A12614,1,2,0,3,0.33,0.67,0.0
A12615,4,1,0,5,0.8,0.2,0.0
A12616,1,2,0,3,0.33,0.67,0.0
A12617,1,3,0,4,0.25,0.75,0.0
A12618,1,6,0,7,0.14,0.86,0.0
A12619,4,5,0,9,0.44,0.56,0.0
A12622,0,2,1,3,0.0,0.67,0.33
A12623,1,20,0,21,0.05,0.95,0.0
A12625,5,9,0,14,0.36,0.64,0.0
A12627,1,1,0,2,0.5,0.5,0.0
A12628,16,11,0,27,0.59,0.41,0.0
A12629,2,13,1,16,0.12,0.81,0.06
A12630,10,7,0,17,0.59,0.41,0.0
A12631,0,1,0,1,0.0,1.0,0.0
A12632,62,27,0,89,0.7,0.3,0.0
A12633,4,11,0,15,0.27,0.73,0.0
A12634,2,2,0,4,0.5,0.5,0.0
A12635,5,6,0,11,0.45,0.55,0.0
A12637,0,2,0,2,0.0,1.0,0.0
A12638,27,12,0,39,0.69,0.31,0.0
A12639,7,17,1,25,0.28,0.68,0.04
A12640,6,4,0,10,0.6,0.4,0.0
A12641,0,1,0,1,0.0,1.0,0.0
A12642,0,3,0,3,0.0,1.0,0.0
A12644,0,2,0,2,0.0,1.0,0.0
A12645,15,7,0,22,0.68,0.32,0.0
A12646,1,1,0,2,0.5,0.5,0.0
A12647,12,0,0,12,1.0,0.0,0.0
A12648,10,4,2,16,0.62,0.25,0.12
A12649,5,3,0,8,0.62,0.38,0.0
A12650,5,7,0,12,0.42,0.58,0.0
A12651,2,2,0,4,0.5,0.5,0.0
A12652,2,6,0,8,0.25,0.75,0.0
A12653,6,6,0,12,0.5,0.5,0.0
A12654,1,2,0,3,0.33,0.67,0.0
A12655,5,4,0,9,0.56,0.44,0.0
A12658,9,13,0,22,0.41,0.59,0.0
A12659,11,7,0,18,0.61,0.39,0.0
A12660,10,18,0,28,0.36,0.64,0.0
A12661,1,0,1,2,0.5,0.0,0.5
A12662,0,1,0,1,0.0,1.0,0.0
A12664,2,3,0,5,0.4,0.6,0.0
A12665,14,11,0,25,0.56,0.44,0.0
A12666,0,2,0,2,0.0,1.0,0.0
A12667,18,7,0,25,0.72,0.28,0.0
A12669,1,9,0,10,0.1,0.9,0.0
A12670,6,2,0,8,0.75,0.25,0.0
A12671,1,7,0,8,0.12,0.88,0.0
A12672,3,6,0,9,0.33,0.67,0.0
A12673,0,6,0,6,0.0,1.0,0.0
A12674,3,3,0,6,0.5,0.5,0.0
A12675,10,8,3,21,0.48,0.38,0.14
A12676,24,7,0,31,0.77,0.23,0.0
A12677,8,5,0,13,0.62,0.38,0.0
A12678,1,5,0,6,0.17,0.83,0.0
A12679,0,1,0,1,0.0,1.0,0.0
A12682,2,3,0,5,0.4,0.6,0.0
A12683,0,1,0,1,0.0,1.0,0.0
A12684,1,2,0,3,0.33,0.67,0.0
A12685,2,3,0,5,0.4,0.6,0.0
A12686,2,25,0,27,0.07,0.93,0.0
A12688,3,8,0,11,0.27,0.73,0.0
A12689,0,4,0,4,0.0,1.0,0.0
A12690,0,2,0,2,0.0,1.0,0.0
A12692,0,1,0,1,0.0,1.0,0.0
A12693,1,3,0,4,0.25,0.75,0.0
A12694,0,2,0,2,0.0,1.0,0.0
A12695,5,15,0,20,0.25,0.75,0.0
A12696,4,4,0,8,0.5,0.5,0.0
A12698,1,4,0,5,0.2,0.8,0.0
A12699,3,2,0,5,0.6,0.4,0.0
A12700,6,21,0,27,0.22,0.78,0.0
A12701,0,1,0,1,0.0,1.0,0.0
A12702,3,2,0,5,0.6,0.4,0.0
A12703,0,2,0,2,0.0,1.0,0.0
A12705,12,9,0,21,0.57,0.43,0.0
A12706,0,1,0,1,0.0,1.0,0.0
A12707,1,4,0,5,0.2,0.8,0.0
A12708,3,11,0,14,0.21,0.79,0.0
A12710,1,1,0,2,0.5,0.5,0.0
A12711,4,5,0,9,0.44,0.56,0.0
A12712,0,6,0,6,0.0,1.0,0.0
A12714,5,7,0,12,0.42,0.58,0.0
A12715,0,6,0,6,0.0,1.0,0.0
A12716,10,4,0,14,0.71,0.29,0.0
A12718,9,2,0,11,0.82,0.18,0.0
A12723,0,1,0,1,0.0,1.0,0.0
A12724,2,4,0,6,0.33,0.67,0.0
A12725,0,3,0,3,0.0,1.0,0.0
A12727,1,0,0,1,1.0,0.0,0.0
A12729,7,2,1,10,0.7,0.2,0.1
A12730,10,6,0,16,0.62,0.38,0.0
A12731,1,8,0,9,0.11,0.89,0.0
A12733,3,17,5,25,0.12,0.68,0.2
A12734,1,3,0,4,0.25,0.75,0.0
A12735,2,9,0,11,0.18,0.82,0.0
A12736,0,1,0,1,0.0,1.0,0.0
A12737,8,11,0,19,0.42,0.58,0.0
A12740,1,0,0,1,1.0,0.0,0.0
A12741,5,3,0,8,0.62,0.38,0.0
A12742,0,5,0,5,0.0,1.0,0.0
A12743,0,3,0,3,0.0,1.0,0.0
A12744,9,4,0,13,0.69,0.31,0.0
A12745,2,0,0,2,1.0,0.0,0.0
A12746,5,5,0,10,0.5,0.5,0.0
A12749,4,6,4,14,0.29,0.43,0.29
A12750,3,1,0,4,0.75,0.25,0.0
A12751,0,1,0,1,0.0,1.0,0.0
A12752,5,6,0,11,0.45,0.55,0.0
A12753,9,8,0,17,0.53,0.47,0.0
A12754,4,7,2,13,0.31,0.54,0.15
A12755,37,34,2,73,0.51,0.47,0.03
A12757,4,1,0,5,0.8,0.2,0.0
A12758,4,9,0,13,0.31,0.69,0.0
A12759,4,2,18,24,0.17,0.08,0.75
A12760,3,12,0,15,0.2,0.8,0.0
A12761,5,7,0,12,0.42,0.58,0.0
A12763,1,1,1,3,0.33,0.33,0.33
A12764,3,3,0,6,0.5,0.5,0.0
A12765,19,5,0,24,0.79,0.21,0.0
A12766,17,34,0,51,0.33,0.67,0.0
A12767,13,16,0,29,0.45,0.55,0.0
A12768,0,2,0,2,0.0,1.0,0.0
A12769,2,4,0,6,0.33,0.67,0.0
A12771,1,1,0,2,0.5,0.5,0.0
A12772,1,3,0,4,0.25,0.75,0.0
A12773,10,4,0,14,0.71,0.29,0.0
A12775,1,2,0,3,0.33,0.67,0.0
A12776,0,1,0,1,0.0,1.0,0.0
A12777,28,1,0,29,0.97,0.03,0.0
A12778,6,1,1,8,0.75,0.12,0.12
A12779,4,5,0,9,0.44,0.56,0.0
A12780,36,82,3,121,0.3,0.68,0.02
A12781,6,2,0,8,0.75,0.25,0.0
A12782,2,6,0,8,0.25,0.75,0.0
A12784,3,0,0,3,1.0,0.0,0.0
A12785,6,6,0,12,0.5,0.5,0.0
A12786,9,13,0,22,0.41,0.59,0.0
A12787,0,1,0,1,0.0,1.0,0.0
A12788,3,4,0,7,0.43,0.57,0.0
A12789,2,1,0,3,0.67,0.33,0.0
A12790,3,3,0,6,0.5,0.5,0.0
A12791,0,5,0,5,0.0,1.0,0.0
A12792,3,5,0,8,0.38,0.62,0.0
A12793,51,161,1,213,0.24,0.76,0.0
A12795,0,1,0,1,0.0,1.0,0.0
A12796,0,1,0,1,0.0,1.0,0.0
A12798,5,5,0,10,0.5,0.5,0.0
A12799,2,0,0,2,1.0,0.0,0.0
A12800,1,4,0,5,0.2,0.8,0.0
A12801,6,5,0,11,0.55,0.45,0.0
A12802,0,2,0,2,0.0,1.0,0.0
A12803,3,6,0,9,0.33,0.67,0.0
A12804,64,12,15,91,0.7,0.13,0.16
A12805,3,4,0,7,0.43,0.57,0.0
A12806,38,22,0,60,0.63,0.37,0.0
A12807,8,6,0,14,0.57,0.43,0.0
A12808,1,2,0,3,0.33,0.67,0.0
A12809,2,3,0,5,0.4,0.6,0.0
A12810,6,15,0,21,0.29,0.71,0.0
A12811,7,6,0,13,0.54,0.46,0.0
A12812,9,4,0,13,0.69,0.31,0.0
A12813,2,2,0,4,0.5,0.5,0.0
A12815,6,4,0,10,0.6,0.4,0.0
A12816,0,5,0,5,0.0,1.0,0.0
A12817,14,19,1,34,0.41,0.56,0.03
A12818,14,11,0,25,0.56,0.44,0.0
A12819,0,1,0,1,0.0,1.0,0.0
A12820,7,6,0,13,0.54,0.46,0.0
A12821,1,1,0,2,0.5,0.5,0.0
A12822,4,1,9,14,0.29,0.07,0.64
A12823,7,5,0,12,0.58,0.42,0.0
A12824,2,4,0,6,0.33,0.67,0.0
A12825,0,3,0,3,0.0,1.0,0.0
A12826,12,10,1,23,0.52,0.43,0.04
A12827,2,6,0,8,0.25,0.75,0.0
A12828,2,3,0,5,0.4,0.6,0.0
A12829,0,1,0,1,0.0,1.0,0.0
A12831,0,4,0,4,0.0,1.0,0.0
A12832,1,2,0,3,0.33,0.67,0.0
A12833,2,0,0,2,1.0,0.0,0.0
A12836,13,12,1,26,0.5,0.46,0.04
A12837,2,2,0,4,0.5,0.5,0.0
A12838,7,3,0,10,0.7,0.3,0.0
A12839,1,3,0,4,0.25,0.75,0.0
A12840,1,5,3,9,0.11,0.56,0.33
A12841,21,4,0,25,0.84,0.16,0.0
A12842,4,3,0,7,0.57,0.43,0.0
A12843,1,1,0,2,0.5,0.5,0.0
A12844,11,12,1,24,0.46,0.5,0.04
A12845,1,9,0,10,0.1,0.9,0.0
A12846,0,2,0,2,0.0,1.0,0.0
A12847,1,0,0,1,1.0,0.0,0.0
A12849,2,12,0,14,0.14,0.86,0.0
A12850,11,9,0,20,0.55,0.45,0.0
A12851,4,4,0,8,0.5,0.5,0.0
A12852,17,15,0,32,0.53,0.47,0.0
A12853,0,1,0,1,0.0,1.0,0.0
A12854,5,1,0,6,0.83,0.17,0.0
A12855,7,2,0,9,0.78,0.22,0.0
A12856,8,11,0,19,0.42,0.58,0.0
A12857,4,3,0,7,0.57,0.43,0.0
A12858,3,5,0,8,0.38,0.62,0.0
A12859,1,3,0,4,0.25,0.75,0.0
A12860,0,5,0,5,0.0,1.0,0.0
A12861,9,5,0,14,0.64,0.36,0.0
A12862,3,8,0,11,0.27,0.73,0.0
A12864,15,8,0,23,0.65,0.35,0.0
A12865,9,8,0,17,0.53,0.47,0.0
A12866,0,3,0,3,0.0,1.0,0.0
A12867,0,1,0,1,0.0,1.0,0.0
A12868,0,1,0,1,0.0,1.0,0.0
A12869,14,4,0,18,0.78,0.22,0.0
A12870,6,2,0,8,0.75,0.25,0.0
A12873,2,0,0,2,1.0,0.0,0.0
A12874,0,3,0,3,0.0,1.0,0.0
A12875,7,7,0,14,0.5,0.5,0.0
A12876,1,3,1,5,0.2,0.6,0.2
A12877,5,11,1,17,0.29,0.65,0.06
A12878,4,6,0,10,0.4,0.6,0.0
A12879,27,59,0,86,0.31,0.69,0.0
A12882,0,5,0,5,0.0,1.0,0.0
A12883,1,6,0,7,0.14,0.86,0.0
A12884,4,10,0,14,0.29,0.71,0.0
A12885,3,23,0,26,0.12,0.88,0.0
A12886,2,5,1,8,0.25,0.62,0.12
A12887,24,11,0,35,0.69,0.31,0.0
A12889,1,3,0,4,0.25,0.75,0.0
A12890,5,5,0,10,0.5,0.5,0.0
A12891,18,26,0,44,0.41,0.59,0.0
A12892,2,4,0,6,0.33,0.67,0.0
A12893,3,4,0,7,0.43,0.57,0.0
A12894,4,4,0,8,0.5,0.5,0.0
A12896,2,2,0,4,0.5,0.5,0.0
A12897,0,0,1,1,0.0,0.0,1.0
A12898,1,1,0,2,0.5,0.5,0.0
A12899,23,11,12,46,0.5,0.24,0.26
A12900,26,15,0,41,0.63,0.37,0.0
A12901,2,3,0,5,0.4,0.6,0.0
A12902,0,1,0,1,0.0,1.0,0.0
A12903,35,18,0,53,0.66,0.34,0.0
A12904,0,6,0,6,0.0,1.0,0.0
A12905,20,11,0,31,0.65,0.35,0.0
A12906,10,6,0,16,0.62,0.38,0.0
A12907,0,1,0,1,0.0,1.0,0.0
A12908,6,7,0,13,0.46,0.54,0.0
A12909,3,3,0,6,0.5,0.5,0.0
A12910,4,1,0,5,0.8,0.2,0.0
A12912,2,1,0,3,0.67,0.33,0.0
A12913,1,8,0,9,0.11,0.89,0.0
A12914,1,5,0,6,0.17,0.83,0.0
A12915,0,1,0,1,0.0,1.0,0.0
A12916,0,2,0,2,0.0,1.0,0.0
A12917,0,1,0,1,0.0,1.0,0.0
A12918,1,2,0,3,0.33,0.67,0.0
A12919,6,6,0,12,0.5,0.5,0.0
A12920,1,3,0,4,0.25,0.75,0.0
A12921,14,4,0,18,0.78,0.22,0.0
A12922,12,15,0,27,0.44,0.56,0.0
A12923,3,0,0,3,1.0,0.0,0.0
A12926,3,1,0,4,0.75,0.25,0.0
A12927,2,1,0,3,0.67,0.33,0.0
A12928,86,16,1,103,0.83,0.16,0.01
A12929,3,0,0,3,1.0,0.0,0.0
A12930,0,5,0,5,0.0,1.0,0.0
A12932,0,2,0,2,0.0,1.0,0.0
A12933,7,2,0,9,0.78,0.22,0.0
A12936,6,4,0,10,0.6,0.4,0.0
A12938,10,27,1,38,0.26,0.71,0.03
A12939,4,7,1,12,0.33,0.58,0.08
A12940,1,1,0,2,0.5,0.5,0.0
A12941,1,0,0,1,1.0,0.0,0.0
A12942,15,5,0,20,0.75,0.25,0.0
A12943,2,6,0,8,0.25,0.75,0.0
A12944,1,5,0,6,0.17,0.83,0.0
A12945,1,0,0,1,1.0,0.0,0.0
A12946,8,2,0,10,0.8,0.2,0.0
A12947,1,2,0,3,0.33,0.67,0.0
A12948,33,20,5,58,0.57,0.34,0.09
A12949,10,7,0,17,0.59,0.41,0.0
A12950,1,2,0,3,0.33,0.67,0.0
A12951,65,110,0,175,0.37,0.63,0.0
A12952,6,8,1,15,0.4,0.53,0.07
A12953,12,13,0,25,0.48,0.52,0.0
A12954,0,1,0,1,0.0,1.0,0.0
A12955,0,2,0,2,0.0,1.0,0.0
A12956,27,14,0,41,0.66,0.34,0.0
A12957,9,1,0,10,0.9,0.1,0.0
A12958,15,5,0,20,0.75,0.25,0.0
A12959,17,9,0,26,0.65,0.35,0.0
A12960,8,5,0,13,0.62,0.38,0.0
A12961,0,5,0,5,0.0,1.0,0.0
A12962,12,28,1,41,0.29,0.68,0.02
A12963,1,9,0,10,0.1,0.9,0.0
A12964,0,6,0,6,0.0,1.0,0.0
A12965,16,11,0,27,0.59,0.41,0.0
A12966,1,1,0,2,0.5,0.5,0.0
A12967,1,3,0,4,0.25,0.75,0.0
A12968,1,2,0,3,0.33,0.67,0.0
A12970,0,2,0,2,0.0,1.0,0.0
A12971,1,8,0,9,0.11,0.89,0.0
A12972,4,6,0,10,0.4,0.6,0.0
A12973,38,116,0,154,0.25,0.75,0.0
A12974,5,4,0,9,0.56,0.44,0.0
A12975,2,0,0,2,1.0,0.0,0.0
A12976,3,4,0,7,0.43,0.57,0.0
A12977,9,14,0,23,0.39,0.61,0.0
A12978,1,10,0,11,0.09,0.91,0.0
A12979,3,1,0,4,0.75,0.25,0.0
A12980,21,29,0,50,0.42,0.58,0.0
A12981,3,2,0,5,0.6,0.4,0.0
A12982,5,13,0,18,0.28,0.72,0.0
A12983,1,0,0,1,1.0,0.0,0.0
A12984,9,17,0,26,0.35,0.65,0.0
A12985,23,24,1,48,0.48,0.5,0.02
A12986,0,5,0,5,0.0,1.0,0.0
A12987,5,3,0,8,0.62,0.38,0.0
A12988,1,3,0,4,0.25,0.75,0.0
A12989,14,16,2,32,0.44,0.5,0.06
A12990,1,2,0,3,0.33,0.67,0.0
A12991,4,16,0,20,0.2,0.8,0.0
A12992,86,38,0,124,0.69,0.31,0.0
A12995,2,6,0,8,0.25,0.75,0.0
A12996,0,1,0,1,0.0,1.0,0.0
A12997,6,40,0,46,0.13,0.87,0.0
A12998,0,3,0,3,0.0,1.0,0.0
A12999,7,4,0,11,0.64,0.36,0.0
A13000,123,27,0,150,0.82,0.18,0.0
A13001,14,7,0,21,0.67,0.33,0.0
A13002,12,3,0,15,0.8,0.2,0.0
A13003,20,11,0,31,0.65,0.35,0.0
A13004,0,4,0,4,0.0,1.0,0.0
A13005,10,3,0,13,0.77,0.23,0.0
A13006,0,2,0,2,0.0,1.0,0.0
A13007,9,3,0,12,0.75,0.25,0.0
A13009,8,4,0,12,0.67,0.33,0.0
A13010,1,3,0,4,0.25,0.75,0.0
A13011,5,4,0,9,0.56,0.44,0.0
A13013,8,2,0,10,0.8,0.2,0.0
A13015,33,15,0,48,0.69,0.31,0.0
A13017,3,1,0,4,0.75,0.25,0.0
A13018,1,1,0,2,0.5,0.5,0.0
A13019,2,3,0,5,0.4,0.6,0.0
A13020,1,1,0,2,0.5,0.5,0.0
A13021,1,1,0,2,0.5,0.5,0.0
A13024,0,1,0,1,0.0,1.0,0.0
A13025,1,0,0,1,1.0,0.0,0.0
A13026,5,5,1,11,0.45,0.45,0.09
A13029,1,0,0,1,1.0,0.0,0.0
A13030,0,1,0,1,0.0,1.0,0.0
A13031,2,4,0,6,0.33,0.67,0.0
A13032,3,3,0,6,0.5,0.5,0.0
A13033,0,1,0,1,0.0,1.0,0.0
A13035,8,10,0,18,0.44,0.56,0.0
A13036,3,1,0,4,0.75,0.25,0.0
A13040,4,1,0,5,0.8,0.2,0.0
A13043,0,3,0,3,0.0,1.0,0.0
A13045,12,4,0,16,0.75,0.25,0.0
A13046,0,1,0,1,0.0,1.0,0.0
A13048,0,1,0,1,0.0,1.0,0.0
A13050,1,8,0,9,0.11,0.89,0.0
A13052,1,3,0,4,0.25,0.75,0.0
A13054,2,4,0,6,0.33,0.67,0.0
A13056,21,5,0,26,0.81,0.19,0.0
A13057,0,1,0,1,0.0,1.0,0.0
A13058,1,1,0,2,0.5,0.5,0.0
A13060,9,2,0,11,0.82,0.18,0.0
A13061,1,0,0,1,1.0,0.0,0.0
A13063,7,0,0,7,1.0,0.0,0.0
A13064,3,2,0,5,0.6,0.4,0.0
A13065,1,1,0,2,0.5,0.5,0.0
A13066,0,1,0,1,0.0,1.0,0.0
A13067,8,6,0,14,0.57,0.43,0.0
A13068,0,3,0,3,0.0,1.0,0.0
A13072,1,7,0,8,0.12,0.88,0.0
A13073,2,1,0,3,0.67,0.33,0.0
A13075,0,2,0,2,0.0,1.0,0.0
A13076,0,1,0,1,0.0,1.0,0.0
A13077,6,8,0,14,0.43,0.57,0.0
A13078,9,10,0,19,0.47,0.53,0.0
A13081,1,0,0,1,1.0,0.0,0.0
A13082,3,6,0,9,0.33,0.67,0.0
A13083,6,7,0,13,0.46,0.54,0.0
A13084,0,4,0,4,0.0,1.0,0.0
A13086,5,8,0,13,0.38,0.62,0.0
A13087,0,3,0,3,0.0,1.0,0.0
A13088,1,11,0,12,0.08,0.92,0.0
A13090,4,2,0,6,0.67,0.33,0.0
A13092,1,1,0,2,0.5,0.5,0.0
A13093,0,1,0,1,0.0,1.0,0.0
A13094,0,3,0,3,0.0,1.0,0.0
A13095,1,5,0,6,0.17,0.83,0.0
A13101,7,11,0,18,0.39,0.61,0.0
A13103,22,21,0,43,0.51,0.49,0.0
A13107,1,9,0,10,0.1,0.9,0.0
A13108,0,2,0,2,0.0,1.0,0.0
A13109,0,4,0,4,0.0,1.0,0.0
A13110,7,9,0,16,0.44,0.56,0.0
A13112,38,5,0,43,0.88,0.12,0.0
A13114,5,7,0,12,0.42,0.58,0.0
A13115,34,16,0,50,0.68,0.32,0.0
A13116,1,3,0,4,0.25,0.75,0.0
A13117,21,17,0,38,0.55,0.45,0.0
A13118,4,11,0,15,0.27,0.73,0.0
A13119,0,1,0,1,0.0,1.0,0.0
A13120,0,1,0,1,0.0,1.0,0.0
A13121,12,39,0,51,0.24,0.76,0.0
A13122,6,1,0,7,0.86,0.14,0.0
A13123,1,0,0,1,1.0,0.0,0.0
A13124,13,10,0,23,0.57,0.43,0.0
A13125,12,8,0,20,0.6,0.4,0.0
A13126,1,0,0,1,1.0,0.0,0.0
A13128,1,5,0,6,0.17,0.83,0.0
A13129,0,2,0,2,0.0,1.0,0.0
A13131,0,1,0,1,0.0,1.0,0.0
A13133,4,7,0,11,0.36,0.64,0.0
A13134,1,1,0,2,0.5,0.5,0.0
A13135,4,13,0,17,0.24,0.76,0.0
A13136,0,1,0,1,0.0,1.0,0.0
A13137,4,4,0,8,0.5,0.5,0.0
A13138,12,18,0,30,0.4,0.6,0.0
A13139,4,10,1,15,0.27,0.67,0.07
A13140,2,7,0,9,0.22,0.78,0.0
A13141,22,33,1,56,0.39,0.59,0.02
A13142,3,2,0,5,0.6,0.4,0.0
A13143,0,22,0,22,0.0,1.0,0.0
A13144,9,20,0,29,0.31,0.69,0.0
A13145,1,4,0,5,0.2,0.8,0.0
A13146,6,3,0,9,0.67,0.33,0.0
A13147,4,22,0,26,0.15,0.85,0.0
A13148,0,3,0,3,0.0,1.0,0.0
A13149,40,46,0,86,0.47,0.53,0.0
A13150,49,20,1,70,0.7,0.29,0.01
A13151,3,21,0,24,0.12,0.88,0.0
A13152,7,25,0,32,0.22,0.78,0.0
A13153,6,13,0,19,0.32,0.68,0.0
A13154,3,8,0,11,0.27,0.73,0.0
A13155,8,13,0,21,0.38,0.62,0.0
A13156,0,1,0,1,0.0,1.0,0.0
A13157,8,7,0,15,0.53,0.47,0.0
A13158,15,23,0,38,0.39,0.61,0.0
A13159,3,5,0,8,0.38,0.62,0.0
A13160,4,17,0,21,0.19,0.81,0.0
A13161,12,25,0,37,0.32,0.68,0.0
A13162,5,5,0,10,0.5,0.5,0.0
A13163,6,10,0,16,0.38,0.62,0.0
A13164,8,18,0,26,0.31,0.69,0.0
A13165,12,28,0,40,0.3,0.7,0.0
A13166,11,6,0,17,0.65,0.35,0.0
A13167,2,10,0,12,0.17,0.83,0.0
A13168,6,7,0,13,0.46,0.54,0.0
A13169,4,14,0,18,0.22,0.78,0.0
A13170,6,22,0,28,0.21,0.79,0.0
A13171,5,4,0,9,0.56,0.44,0.0
A13172,5,3,0,8,0.62,0.38,0.0
A13173,0,4,0,4,0.0,1.0,0.0
A13175,6,10,0,16,0.38,0.62,0.0
A13176,7,14,0,21,0.33,0.67,0.0
A13177,6,3,1,10,0.6,0.3,0.1
A13178,7,25,0,32,0.22,0.78,0.0
A13179,5,14,0,19,0.26,0.74,0.0
A13180,595,833,61,1489,0.4,0.56,0.04
A13181,19,29,1,49,0.39,0.59,0.02
A13182,101,46,7,154,0.66,0.3,0.05
A13183,4,7,0,11,0.36,0.64,0.0
A13184,23,11,0,34,0.68,0.32,0.0
A13185,13,18,0,31,0.42,0.58,0.0
A13186,19,27,0,46,0.41,0.59,0.0
A13187,17,12,0,29,0.59,0.41,0.0
A13188,14,13,0,27,0.52,0.48,0.0
A13189,0,3,0,3,0.0,1.0,0.0
A13190,2,19,0,21,0.1,0.9,0.0
A13191,23,26,0,49,0.47,0.53,0.0
A13192,8,15,0,23,0.35,0.65,0.0
A13193,16,35,0,51,0.31,0.69,0.0
A13194,13,8,0,21,0.62,0.38,0.0
A13195,14,70,0,84,0.17,0.83,0.0
A13196,2,4,0,6,0.33,0.67,0.0
A13197,10,7,0,17,0.59,0.41,0.0
A13198,3,31,0,34,0.09,0.91,0.0
A13199,2,6,0,8,0.25,0.75,0.0
A13200,3,15,0,18,0.17,0.83,0.0
A13201,15,13,0,28,0.54,0.46,0.0
A13202,9,32,0,41,0.22,0.78,0.0
A13203,3,7,0,10,0.3,0.7,0.0
A13204,4,14,0,18,0.22,0.78,0.0
A13205,7,6,0,13,0.54,0.46,0.0
A13206,1,4,0,5,0.2,0.8,0.0
A13207,2,16,0,18,0.11,0.89,0.0
A13208,7,18,0,25,0.28,0.72,0.0
A13209,3,16,0,19,0.16,0.84,0.0
A13210,10,51,0,61,0.16,0.84,0.0
A13211,3,8,0,11,0.27,0.73,0.0
A13212,2,11,0,13,0.15,0.85,0.0
A13213,27,15,0,42,0.64,0.36,0.0
A13214,11,38,0,49,0.22,0.78,0.0
A13215,49,81,0,130,0.38,0.62,0.0
A13216,14,35,0,49,0.29,0.71,0.0
A13217,0,3,0,3,0.0,1.0,0.0
A13218,14,11,0,25,0.56,0.44,0.0
A13219,3,16,0,19,0.16,0.84,0.0
A13220,9,7,0,16,0.56,0.44,0.0
A13221,1,4,0,5,0.2,0.8,0.0
A13222,4,16,0,20,0.2,0.8,0.0
A13223,3,9,0,12,0.25,0.75,0.0
A13225,468,1015,17,1500,0.31,0.68,0.01
A13226,11,10,0,21,0.52,0.48,0.0
A13227,32,199,0,231,0.14,0.86,0.0
A13228,3,10,0,13,0.23,0.77,0.0
A13229,13,21,2,36,0.36,0.58,0.06
A13230,5,16,0,21,0.24,0.76,0.0
A13231,27,236,0,263,0.1,0.9,0.0
A13232,23,168,0,191,0.12,0.88,0.0
A13233,2,5,0,7,0.29,0.71,0.0
A13234,19,41,0,60,0.32,0.68,0.0
A13235,24,28,0,52,0.46,0.54,0.0
A13236,10,39,0,49,0.2,0.8,0.0
A13237,26,14,24,64,0.41,0.22,0.38
A13238,36,44,0,80,0.45,0.55,0.0
A13239,4,12,0,16,0.25,0.75,0.0
A13240,24,32,0,56,0.43,0.57,0.0
A13241,5,22,0,27,0.19,0.81,0.0
A13242,0,4,0,4,0.0,1.0,0.0
A13243,7,8,0,15,0.47,0.53,0.0
A13244,3,21,3,27,0.11,0.78,0.11
A13245,19,14,5,38,0.5,0.37,0.13
A13246,12,7,0,19,0.63,0.37,0.0
A13247,28,41,1,70,0.4,0.59,0.01
A13248,10,10,0,20,0.5,0.5,0.0
A13249,31,29,0,60,0.52,0.48,0.0
A13250,0,10,0,10,0.0,1.0,0.0
A13251,20,30,0,50,0.4,0.6,0.0
A13252,7,13,1,21,0.33,0.62,0.05
A13253,1,8,0,9,0.11,0.89,0.0
A13254,15,17,0,32,0.47,0.53,0.0
A13255,1,17,0,18,0.06,0.94,0.0
A13256,5,5,0,10,0.5,0.5,0.0
A13257,3,5,0,8,0.38,0.62,0.0
A13258,4,9,0,13,0.31,0.69,0.0
A13259,4,7,0,11,0.36,0.64,0.0
A13260,0,2,0,2,0.0,1.0,0.0
A13261,1,5,0,6,0.17,0.83,0.0
A13262,16,23,0,39,0.41,0.59,0.0
A13263,1,2,0,3,0.33,0.67,0.0
A13264,1,3,0,4,0.25,0.75,0.0
A13265,4,10,0,14,0.29,0.71,0.0
A13266,0,11,0,11,0.0,1.0,0.0
A13267,7,11,0,18,0.39,0.61,0.0
A13268,9,8,0,17,0.53,0.47,0.0
A13269,1,3,0,4,0.25,0.75,0.0
A13270,12,5,0,17,0.71,0.29,0.0
A13271,7,31,0,38,0.18,0.82,0.0
A13272,0,1,0,1,0.0,1.0,0.0
A13273,1,2,0,3,0.33,0.67,0.0
A13274,2,6,0,8,0.25,0.75,0.0
A13275,15,10,0,25,0.6,0.4,0.0
A13276,14,20,0,34,0.41,0.59,0.0
A13277,48,12,0,60,0.8,0.2,0.0
A13278,21,46,0,67,0.31,0.69,0.0
A13280,8,9,0,17,0.47,0.53,0.0
A13281,36,24,0,60,0.6,0.4,0.0
A13282,6,4,0,10,0.6,0.4,0.0
A13283,0,3,0,3,0.0,1.0,0.0
A13284,21,14,0,35,0.6,0.4,0.0
A13285,8,7,1,16,0.5,0.44,0.06
A13286,11,12,0,23,0.48,0.52,0.0
A13287,0,5,0,5,0.0,1.0,0.0
A13288,2,7,0,9,0.22,0.78,0.0
A13289,4,11,0,15,0.27,0.73,0.0
A13291,1,4,0,5,0.2,0.8,0.0
A13292,3,7,0,10,0.3,0.7,0.0
A13293,3,5,0,8,0.38,0.62,0.0
A13294,11,28,0,39,0.28,0.72,0.0
A13295,4,14,0,18,0.22,0.78,0.0
A13296,6,19,0,25,0.24,0.76,0.0
A13297,16,11,0,27,0.59,0.41,0.0
A13298,5,15,0,20,0.25,0.75,0.0
A13299,5,9,0,14,0.36,0.64,0.0
A13300,6,6,0,12,0.5,0.5,0.0
A13301,6,17,0,23,0.26,0.74,0.0
A13302,2,18,0,20,0.1,0.9,0.0
A13303,1,1,0,2,0.5,0.5,0.0
A13304,95,161,1,257,0.37,0.63,0.0
A13305,46,24,0,70,0.66,0.34,0.0
A13306,1,9,0,10,0.1,0.9,0.0
A13307,17,23,3,43,0.4,0.53,0.07
A13308,13,5,0,18,0.72,0.28,0.0
A13309,157,133,1,291,0.54,0.46,0.0
A13310,4,10,0,14,0.29,0.71,0.0
A13311,10,9,0,19,0.53,0.47,0.0
A13312,5,7,0,12,0.42,0.58,0.0
A13313,9,19,0,28,0.32,0.68,0.0
A13314,3,4,0,7,0.43,0.57,0.0
A13315,0,0,7,7,0.0,0.0,1.0
A13316,69,129,5,203,0.34,0.64,0.02
A13317,14,17,0,31,0.45,0.55,0.0
A13318,0,6,0,6,0.0,1.0,0.0
A13320,25,33,0,58,0.43,0.57,0.0
A13321,33,19,0,52,0.63,0.37,0.0
A13322,60,43,0,103,0.58,0.42,0.0
A13324,20,15,0,35,0.57,0.43,0.0
A13325,16,9,0,25,0.64,0.36,0.0
A13326,12,8,1,21,0.57,0.38,0.05
A13327,1,5,0,6,0.17,0.83,0.0
A13328,13,22,0,35,0.37,0.63,0.0
A13329,14,20,1,35,0.4,0.57,0.03
A13330,18,10,0,28,0.64,0.36,0.0
A13331,3,5,0,8,0.38,0.62,0.0
A13332,7,18,0,25,0.28,0.72,0.0
A13333,2,7,0,9,0.22,0.78,0.0
A13334,1,5,0,6,0.17,0.83,0.0
A13335,0,1,0,1,0.0,1.0,0.0
A13336,2,3,0,5,0.4,0.6,0.0
A13337,19,21,0,40,0.47,0.53,0.0
A13338,13,8,0,21,0.62,0.38,0.0
A13339,5,13,0,18,0.28,0.72,0.0
A13340,1,1,0,2,0.5,0.5,0.0
A13341,9,26,0,35,0.26,0.74,0.0
A13343,2,4,0,6,0.33,0.67,0.0
A13344,403,355,0,758,0.53,0.47,0.0
A13345,11,15,0,26,0.42,0.58,0.0
A13346,9,5,0,14,0.64,0.36,0.0
A13349,6,7,0,13,0.46,0.54,0.0
A13350,9,10,0,19,0.47,0.53,0.0
A13351,43,54,1,98,0.44,0.55,0.01
A13352,14,12,0,26,0.54,0.46,0.0
A13353,9,18,0,27,0.33,0.67,0.0
A13354,0,2,0,2,0.0,1.0,0.0
A13355,45,12,0,57,0.79,0.21,0.0
A13356,1,2,0,3,0.33,0.67,0.0
A13357,9,90,0,99,0.09,0.91,0.0
A13358,17,14,0,31,0.55,0.45,0.0
A13359,0,6,0,6,0.0,1.0,0.0
A13360,8,9,0,17,0.47,0.53,0.0
A13361,19,16,0,35,0.54,0.46,0.0
A13362,7,10,0,17,0.41,0.59,0.0
A13363,0,5,0,5,0.0,1.0,0.0
A13365,1,0,0,1,1.0,0.0,0.0
A13366,0,2,0,2,0.0,1.0,0.0
A13367,0,1,0,1,0.0,1.0,0.0
A13368,0,4,0,4,0.0,1.0,0.0
A13369,4,13,0,17,0.24,0.76,0.0
A13370,14,14,4,32,0.44,0.44,0.12
A13371,21,22,4,47,0.45,0.47,0.09
A13372,6,5,1,12,0.5,0.42,0.08
A13373,13,12,0,25,0.52,0.48,0.0
A13374,5,8,0,13,0.38,0.62,0.0
A13375,8,5,0,13,0.62,0.38,0.0
A13376,7,5,0,12,0.58,0.42,0.0
A13377,1,0,1,2,0.5,0.0,0.5
A13378,13,0,1,14,0.93,0.0,0.07
A13380,7,12,0,19,0.37,0.63,0.0
A13381,15,9,1,25,0.6,0.36,0.04
A13383,2,1,0,3,0.67,0.33,0.0
A13384,5,9,0,14,0.36,0.64,0.0
A13385,9,22,2,33,0.27,0.67,0.06
A13386,2,8,0,10,0.2,0.8,0.0
A13387,3,13,0,16,0.19,0.81,0.0
A13388,3,6,0,9,0.33,0.67,0.0
A13389,5,10,0,15,0.33,0.67,0.0
A13390,1,11,0,12,0.08,0.92,0.0
A13391,2,13,0,15,0.13,0.87,0.0
A13392,6,9,0,15,0.4,0.6,0.0
A13393,0,1,0,1,0.0,1.0,0.0
A13394,4,10,0,14,0.29,0.71,0.0
A13395,19,11,0,30,0.63,0.37,0.0
A13396,1,0,0,1,1.0,0.0,0.0
A13397,0,1,0,1,0.0,1.0,0.0
A13399,0,1,0,1,0.0,1.0,0.0
A13400,5,16,0,21,0.24,0.76,0.0
A13401,12,16,0,28,0.43,0.57,0.0
A13403,0,3,0,3,0.0,1.0,0.0
A13404,0,9,0,9,0.0,1.0,0.0
A13405,14,10,0,24,0.58,0.42,0.0
A13406,4,10,0,14,0.29,0.71,0.0
A13407,2,4,0,6,0.33,0.67,0.0
A13409,2,3,0,5,0.4,0.6,0.0
A13410,0,3,0,3,0.0,1.0,0.0
A13411,40,10,0,50,0.8,0.2,0.0
A13413,6,7,0,13,0.46,0.54,0.0
A13415,1,4,0,5,0.2,0.8,0.0
A13416,0,1,0,1,0.0,1.0,0.0
A13417,8,13,0,21,0.38,0.62,0.0
A13418,4,7,0,11,0.36,0.64,0.0
A13419,1,3,0,4,0.25,0.75,0.0
A13420,11,8,0,19,0.58,0.42,0.0
A13421,11,17,0,28,0.39,0.61,0.0
A13422,16,7,1,24,0.67,0.29,0.04
A13423,1,1,0,2,0.5,0.5,0.0
A13424,1,2,0,3,0.33,0.67,0.0
A13425,1,3,0,4,0.25,0.75,0.0
A13427,1,2,0,3,0.33,0.67,0.0
A13428,1,4,0,5,0.2,0.8,0.0
A13429,0,2,0,2,0.0,1.0,0.0
A13430,11,19,0,30,0.37,0.63,0.0
A13432,3,4,0,7,0.43,0.57,0.0
A13433,13,11,0,24,0.54,0.46,0.0
A13434,1,4,0,5,0.2,0.8,0.0
A13435,1,3,0,4,0.25,0.75,0.0
A13436,4,6,0,10,0.4,0.6,0.0
A13437,4,16,0,20,0.2,0.8,0.0
A13438,7,5,0,12,0.58,0.42,0.0
A13439,4,5,0,9,0.44,0.56,0.0
A13440,0,4,0,4,0.0,1.0,0.0
A13441,2,2,0,4,0.5,0.5,0.0
A13442,13,8,0,21,0.62,0.38,0.0
A13443,1,1,0,2,0.5,0.5,0.0
A13444,20,27,0,47,0.43,0.57,0.0
A13445,7,5,0,12,0.58,0.42,0.0
A13446,19,11,0,30,0.63,0.37,0.0
A13447,1,1,0,2,0.5,0.5,0.0
A13448,11,9,0,20,0.55,0.45,0.0
A13450,33,10,1,44,0.75,0.23,0.02
A13451,1,1,0,2,0.5,0.5,0.0
A13452,4,1,0,5,0.8,0.2,0.0
A13453,9,3,0,12,0.75,0.25,0.0
A13454,2,1,0,3,0.67,0.33,0.0
A13455,0,1,0,1,0.0,1.0,0.0
A13456,2,19,0,21,0.1,0.9,0.0
A13457,3,7,0,10,0.3,0.7,0.0
A13458,5,8,0,13,0.38,0.62,0.0
A13459,1,1,0,2,0.5,0.5,0.0
A13460,8,11,0,19,0.42,0.58,0.0
A13461,0,3,0,3,0.0,1.0,0.0
A13462,0,1,0,1,0.0,1.0,0.0
A13463,15,24,0,39,0.38,0.62,0.0
A13464,8,6,0,14,0.57,0.43,0.0
A13465,2,2,0,4,0.5,0.5,0.0
A13467,6,3,0,9,0.67,0.33,0.0
A13468,7,6,0,13,0.54,0.46,0.0
A13469,2,8,0,10,0.2,0.8,0.0
A13470,1,2,0,3,0.33,0.67,0.0
A13471,1,0,0,1,1.0,0.0,0.0
A13472,8,5,0,13,0.62,0.38,0.0
A13474,1,2,0,3,0.33,0.67,0.0
A13475,10,14,0,24,0.42,0.58,0.0
A13476,5,3,0,8,0.62,0.38,0.0
A13477,14,3,18,35,0.4,0.09,0.51
A13478,4,23,0,27,0.15,0.85,0.0
A13479,0,1,0,1,0.0,1.0,0.0
A13480,21,16,0,37,0.57,0.43,0.0
A13481,0,3,0,3,0.0,1.0,0.0
A13482,2,5,0,7,0.29,0.71,0.0
A13483,0,1,0,1,0.0,1.0,0.0
A13485,7,5,0,12,0.58,0.42,0.0
A13486,11,2,0,13,0.85,0.15,0.0
A13487,21,9,0,30,0.7,0.3,0.0
A13488,3,2,0,5,0.6,0.4,0.0
A13489,25,27,0,52,0.48,0.52,0.0
A13492,2,10,0,12,0.17,0.83,0.0
A13493,17,24,0,41,0.41,0.59,0.0
A13495,6,13,0,19,0.32,0.68,0.0
A13497,0,3,0,3,0.0,1.0,0.0
A13498,11,28,0,39,0.28,0.72,0.0
A13499,2,5,1,8,0.25,0.62,0.12
A13501,5,5,0,10,0.5,0.5,0.0
A13502,37,55,0,92,0.4,0.6,0.0
A13503,11,3,0,14,0.79,0.21,0.0
A13504,5,2,0,7,0.71,0.29,0.0
A13505,8,20,0,28,0.29,0.71,0.0
A13506,3,5,0,8,0.38,0.62,0.0
A13507,36,41,0,77,0.47,0.53,0.0
A13511,0,2,0,2,0.0,1.0,0.0
A13512,4,7,2,13,0.31,0.54,0.15
A13513,4,3,0,7,0.57,0.43,0.0
A13515,5,3,0,8,0.62,0.38,0.0
A13516,3,6,0,9,0.33,0.67,0.0
A13517,3,15,0,18,0.17,0.83,0.0
A13518,1,1,0,2,0.5,0.5,0.0
A13519,1,20,1,22,0.05,0.91,0.05
A13521,1,6,0,7,0.14,0.86,0.0
A13522,0,4,0,4,0.0,1.0,0.0
A13523,44,52,0,96,0.46,0.54,0.0
A13525,1,2,0,3,0.33,0.67,0.0
A13528,1,1,0,2,0.5,0.5,0.0
A13529,1,2,0,3,0.33,0.67,0.0
A13530,3,4,1,8,0.38,0.5,0.12
A13531,0,10,0,10,0.0,1.0,0.0
A13532,37,63,0,100,0.37,0.63,0.0
A13533,1,0,0,1,1.0,0.0,0.0
A13534,9,11,0,20,0.45,0.55,0.0
A13535,24,17,1,42,0.57,0.4,0.02
A13536,3,5,0,8,0.38,0.62,0.0
A13538,2,8,0,10,0.2,0.8,0.0
A13539,7,18,0,25,0.28,0.72,0.0
A13540,16,12,0,28,0.57,0.43,0.0
A13541,1,2,0,3,0.33,0.67,0.0
A13542,1,0,0,1,1.0,0.0,0.0
A13543,3,11,0,14,0.21,0.79,0.0
A13549,3,3,0,6,0.5,0.5,0.0
A13552,29,78,0,107,0.27,0.73,0.0
A13553,10,17,0,27,0.37,0.63,0.0
A13554,9,6,0,15,0.6,0.4,0.0
A13556,4,7,0,11,0.36,0.64,0.0
A13559,5,16,3,24,0.21,0.67,0.12
A13560,6,12,0,18,0.33,0.67,0.0
A13561,0,6,0,6,0.0,1.0,0.0
A13562,71,25,1,97,0.73,0.26,0.01
A13563,5,8,0,13,0.38,0.62,0.0
A13564,3,6,1,10,0.3,0.6,0.1
A13566,9,5,0,14,0.64,0.36,0.0
A13567,6,13,0,19,0.32,0.68,0.0
A13568,50,32,0,82,0.61,0.39,0.0
A13569,14,9,0,23,0.61,0.39,0.0
A13570,2,2,1,5,0.4,0.4,0.2
A13572,19,36,0,55,0.35,0.65,0.0
A13573,3,4,0,7,0.43,0.57,0.0
A13575,0,2,0,2,0.0,1.0,0.0
A13576,4,4,0,8,0.5,0.5,0.0
A13577,11,12,0,23,0.48,0.52,0.0
A13578,3,10,0,13,0.23,0.77,0.0
A13581,20,32,0,52,0.38,0.62,0.0
A13582,0,1,0,1,0.0,1.0,0.0
A13584,3,4,0,7,0.43,0.57,0.0
A13585,31,52,0,83,0.37,0.63,0.0
A13586,17,47,0,64,0.27,0.73,0.0
A13588,19,22,0,41,0.46,0.54,0.0
A13591,1,0,0,1,1.0,0.0,0.0
A13592,0,1,0,1,0.0,1.0,0.0
A13594,21,38,0,59,0.36,0.64,0.0
A13595,4,3,0,7,0.57,0.43,0.0
A13596,1,0,1,2,0.5,0.0,0.5
A13597,5,4,0,9,0.56,0.44,0.0
A13598,10,6,0,16,0.62,0.38,0.0
A13599,53,7,0,60,0.88,0.12,0.0
A13600,5,6,0,11,0.45,0.55,0.0
A13603,0,1,0,1,0.0,1.0,0.0
A13604,8,6,0,14,0.57,0.43,0.0
A13605,1,1,0,2,0.5,0.5,0.0
A13606,1,1,0,2,0.5,0.5,0.0
A13607,7,0,7,14,0.5,0.0,0.5
A13609,11,20,0,31,0.35,0.65,0.0
A13610,19,40,0,59,0.32,0.68,0.0
A13611,0,1,1,2,0.0,0.5,0.5
A13613,0,1,0,1,0.0,1.0,0.0
A13614,3,3,0,6,0.5,0.5,0.0
A13615,17,13,1,31,0.55,0.42,0.03
A13616,36,20,0,56,0.64,0.36,0.0
A13617,5,38,0,43,0.12,0.88,0.0
A13618,2,1,0,3,0.67,0.33,0.0
A13619,8,10,0,18,0.44,0.56,0.0
A13621,2,2,0,4,0.5,0.5,0.0
A13622,6,10,0,16,0.38,0.62,0.0
A13624,7,10,0,17,0.41,0.59,0.0
A13625,1,2,0,3,0.33,0.67,0.0
A13626,6,22,0,28,0.21,0.79,0.0
A13627,4,2,0,6,0.67,0.33,0.0
A13628,5,17,0,22,0.23,0.77,0.0
A13630,0,1,0,1,0.0,1.0,0.0
A13631,0,0,1,1,0.0,0.0,1.0
A13632,2,1,0,3,0.67,0.33,0.0
A13635,4,7,0,11,0.36,0.64,0.0
A13638,18,12,3,33,0.55,0.36,0.09
A13640,4,2,0,6,0.67,0.33,0.0
A13642,2,0,0,2,1.0,0.0,0.0
A13643,8,9,0,17,0.47,0.53,0.0
A13644,25,15,0,40,0.62,0.38,0.0
A13645,3,0,3,6,0.5,0.0,0.5
A13646,2,3,0,5,0.4,0.6,0.0
A13647,2,1,0,3,0.67,0.33,0.0
A13648,1,0,0,1,1.0,0.0,0.0
A13649,19,15,0,34,0.56,0.44,0.0
A13650,4,5,0,9,0.44,0.56,0.0
A13651,8,14,0,22,0.36,0.64,0.0
A13653,0,1,0,1,0.0,1.0,0.0
A13654,3,8,0,11,0.27,0.73,0.0
A13656,1,4,0,5,0.2,0.8,0.0
A13657,6,6,0,12,0.5,0.5,0.0
A13658,0,1,0,1,0.0,1.0,0.0
A13659,17,52,0,69,0.25,0.75,0.0
A13660,2,3,0,5,0.4,0.6,0.0
A13662,1,0,0,1,1.0,0.0,0.0
A13663,0,1,0,1,0.0,1.0,0.0
A13664,3,1,0,4,0.75,0.25,0.0
A13665,1,3,0,4,0.25,0.75,0.0
A13666,1,0,0,1,1.0,0.0,0.0
A13668,20,23,0,43,0.47,0.53,0.0
A13669,11,16,0,27,0.41,0.59,0.0
A13670,3,6,0,9,0.33,0.67,0.0
A13671,9,6,1,16,0.56,0.38,0.06
A13672,4,36,0,40,0.1,0.9,0.0
A13673,1,1,0,2,0.5,0.5,0.0
A13674,19,34,0,53,0.36,0.64,0.0
A13675,19,24,0,43,0.44,0.56,0.0
A13676,2,4,0,6,0.33,0.67,0.0
A13677,3,19,2,24,0.12,0.79,0.08
A13678,1,2,0,3,0.33,0.67,0.0
A13679,0,3,0,3,0.0,1.0,0.0
A13680,0,2,0,2,0.0,1.0,0.0
A13682,6,13,0,19,0.32,0.68,0.0
A13683,4,13,0,17,0.24,0.76,0.0
A13684,571,869,56,1496,0.38,0.58,0.04
A13685,18,219,1,238,0.08,0.92,0.0
A13686,3,6,1,10,0.3,0.6,0.1
A13687,11,9,14,34,0.32,0.26,0.41
A13688,12,10,1,23,0.52,0.43,0.04
A13689,13,17,31,61,0.21,0.28,0.51
A13690,1,2,7,10,0.1,0.2,0.7
A13691,2,9,0,11,0.18,0.82,0.0
A13692,8,27,0,35,0.23,0.77,0.0
A13693,2,11,0,13,0.15,0.85,0.0
A13694,9,2,6,17,0.53,0.12,0.35
A13695,13,79,1,93,0.14,0.85,0.01
A13696,5,9,0,14,0.36,0.64,0.0
A13697,43,35,2,80,0.54,0.44,0.03
A13698,5,6,3,14,0.36,0.43,0.21
A13699,9,14,1,24,0.38,0.58,0.04
A13700,2,3,0,5,0.4,0.6,0.0
A13701,21,11,47,79,0.27,0.14,0.59
A13702,1,7,9,17,0.06,0.41,0.53
A13703,46,81,2,129,0.36,0.63,0.02
A13704,9,12,1,22,0.41,0.55,0.05
A13705,2,10,1,13,0.15,0.77,0.08
A13706,7,1,4,12,0.58,0.08,0.33
A13707,4,2,0,6,0.67,0.33,0.0
A13708,2,4,0,6,0.33,0.67,0.0
A13709,10,10,1,21,0.48,0.48,0.05
A13710,6,6,1,13,0.46,0.46,0.08
A13711,4,8,0,12,0.33,0.67,0.0
A13712,2,0,1,3,0.67,0.0,0.33
A13713,2,2,1,5,0.4,0.4,0.2
A13714,34,20,3,57,0.6,0.35,0.05
A13715,21,17,1,39,0.54,0.44,0.03
A13716,27,21,1,49,0.55,0.43,0.02
A13717,4,3,0,7,0.57,0.43,0.0
A13718,5,6,0,11,0.45,0.55,0.0
A13719,9,12,0,21,0.43,0.57,0.0
A13720,10,12,1,23,0.43,0.52,0.04
A13721,41,36,4,81,0.51,0.44,0.05
A13722,4,10,0,14,0.29,0.71,0.0
A13723,7,10,0,17,0.41,0.59,0.0
A13724,7,7,0,14,0.5,0.5,0.0
A13725,9,2,0,11,0.82,0.18,0.0
A13726,4,11,0,15,0.27,0.73,0.0
A13727,12,7,1,20,0.6,0.35,0.05
A13728,30,10,0,40,0.75,0.25,0.0
A13729,0,2,0,2,0.0,1.0,0.0
A13730,25,20,1,46,0.54,0.43,0.02
A13731,0,2,0,2,0.0,1.0,0.0
A13732,4,31,0,35,0.11,0.89,0.0
A13733,6,3,0,9,0.67,0.33,0.0
A13734,0,1,0,1,0.0,1.0,0.0
A13737,4,7,0,11,0.36,0.64,0.0
A13738,237,53,9,299,0.79,0.18,0.03
A13739,17,19,0,36,0.47,0.53,0.0
A13740,2,0,0,2,1.0,0.0,0.0
A13741,2,5,0,7,0.29,0.71,0.0
A13742,16,5,0,21,0.76,0.24,0.0
A13743,3,2,0,5,0.6,0.4,0.0
A13744,14,16,0,30,0.47,0.53,0.0
A13748,89,39,0,128,0.7,0.3,0.0
A13749,18,10,0,28,0.64,0.36,0.0
A13750,2,7,1,10,0.2,0.7,0.1
A13751,1,6,0,7,0.14,0.86,0.0
A13752,22,31,0,53,0.42,0.58,0.0
A13753,10,9,0,19,0.53,0.47,0.0
A13754,1,3,0,4,0.25,0.75,0.0
A13755,10,8,0,18,0.56,0.44,0.0
A13756,17,22,0,39,0.44,0.56,0.0
A13757,11,23,0,34,0.32,0.68,0.0
A13758,55,25,0,80,0.69,0.31,0.0
A13760,23,8,0,31,0.74,0.26,0.0
A13761,3,4,0,7,0.43,0.57,0.0
A13762,19,21,0,40,0.47,0.53,0.0
A13763,46,21,2,69,0.67,0.3,0.03
A13764,2,3,0,5,0.4,0.6,0.0
A13765,25,20,1,46,0.54,0.43,0.02
A13766,10,22,0,32,0.31,0.69,0.0
A13768,12,9,0,21,0.57,0.43,0.0
A13769,1,8,0,9,0.11,0.89,0.0
A13770,50,135,5,190,0.26,0.71,0.03
A13771,14,7,0,21,0.67,0.33,0.0
A13772,3,3,0,6,0.5,0.5,0.0
A13773,29,11,0,40,0.72,0.28,0.0
A13774,3,3,1,7,0.43,0.43,0.14
A13775,4,0,0,4,1.0,0.0,0.0
A13776,1,5,0,6,0.17,0.83,0.0
A13777,1,7,0,8,0.12,0.88,0.0
A13778,1,2,0,3,0.33,0.67,0.0
A13780,1,1,0,2,0.5,0.5,0.0
A13781,15,9,0,24,0.62,0.38,0.0
A13783,12,13,0,25,0.48,0.52,0.0
A13784,19,28,0,47,0.4,0.6,0.0
A13785,17,18,0,35,0.49,0.51,0.0
A13786,67,12,24,103,0.65,0.12,0.23
A13787,7,4,0,11,0.64,0.36,0.0
A13788,3,0,0,3,1.0,0.0,0.0
A13789,6,13,0,19,0.32,0.68,0.0
A13790,10,4,2,16,0.62,0.25,0.12
A13791,3,4,0,7,0.43,0.57,0.0
A13792,5,1,0,6,0.83,0.17,0.0
A13794,2,1,0,3,0.67,0.33,0.0
A13797,1,5,0,6,0.17,0.83,0.0
A13799,5,5,1,11,0.45,0.45,0.09
A13800,7,12,0,19,0.37,0.63,0.0
A13801,1,0,0,1,1.0,0.0,0.0
A13802,8,9,1,18,0.44,0.5,0.06
A13803,23,13,0,36,0.64,0.36,0.0
A13804,1,4,0,5,0.2,0.8,0.0
A13805,7,11,0,18,0.39,0.61,0.0
A13806,1,0,0,1,1.0,0.0,0.0
A13808,2,7,0,9,0.22,0.78,0.0
A13809,7,32,3,42,0.17,0.76,0.07
A13810,7,6,1,14,0.5,0.43,0.07
A13811,1,1,0,2,0.5,0.5,0.0
A13812,1,1,0,2,0.5,0.5,0.0
A13813,1,1,0,2,0.5,0.5,0.0
A13814,3,7,0,10,0.3,0.7,0.0
A13815,0,1,0,1,0.0,1.0,0.0
A13816,0,2,0,2,0.0,1.0,0.0
A13818,0,14,0,14,0.0,1.0,0.0
A13819,0,17,0,17,0.0,1.0,0.0
A13820,1,0,0,1,1.0,0.0,0.0
A13821,0,1,0,1,0.0,1.0,0.0
A13822,25,30,1,56,0.45,0.54,0.02
A13823,0,1,0,1,0.0,1.0,0.0
A13824,0,1,0,1,0.0,1.0,0.0
A13825,0,1,0,1,0.0,1.0,0.0
A13827,1,1,0,2,0.5,0.5,0.0
A13828,0,3,0,3,0.0,1.0,0.0
A13829,20,33,1,54,0.37,0.61,0.02
A13830,16,31,0,47,0.34,0.66,0.0
A13832,0,1,0,1,0.0,1.0,0.0
A13833,0,1,0,1,0.0,1.0,0.0
A13834,0,2,0,2,0.0,1.0,0.0
A13835,3,5,0,8,0.38,0.62,0.0
A13836,1,5,0,6,0.17,0.83,0.0
A13837,13,9,0,22,0.59,0.41,0.0
A13839,1,0,0,1,1.0,0.0,0.0
A13840,1,0,0,1,1.0,0.0,0.0
A13841,2,1,0,3,0.67,0.33,0.0
A13845,0,1,0,1,0.0,1.0,0.0
A13847,1,1,0,2,0.5,0.5,0.0
A13848,8,13,0,21,0.38,0.62,0.0
A13850,37,31,0,68,0.54,0.46,0.0
A13851,0,1,0,1,0.0,1.0,0.0
A13853,2,4,0,6,0.33,0.67,0.0
A13854,1,3,0,4,0.25,0.75,0.0
A13856,6,11,0,17,0.35,0.65,0.0
A13857,1,1,0,2,0.5,0.5,0.0
A13858,0,1,0,1,0.0,1.0,0.0
A13859,0,3,0,3,0.0,1.0,0.0
A13860,8,17,0,25,0.32,0.68,0.0
A13862,2,5,0,7,0.29,0.71,0.0
A13864,1,0,0,1,1.0,0.0,0.0
A13865,6,20,0,26,0.23,0.77,0.0
A13866,1,2,0,3,0.33,0.67,0.0
A13869,14,38,1,53,0.26,0.72,0.02
A13870,0,1,1,2,0.0,0.5,0.5
A13871,12,15,1,28,0.43,0.54,0.04
A13873,2,3,1,6,0.33,0.5,0.17
A13874,10,7,0,17,0.59,0.41,0.0
A13877,4,4,2,10,0.4,0.4,0.2
A13878,8,10,0,18,0.44,0.56,0.0
A13879,22,11,0,33,0.67,0.33,0.0
A13880,0,2,0,2,0.0,1.0,0.0
A13882,3,1,0,4,0.75,0.25,0.0
A13885,2,2,2,6,0.33,0.33,0.33
A13886,3,3,0,6,0.5,0.5,0.0
A13887,0,1,0,1,0.0,1.0,0.0
A13889,13,14,0,27,0.48,0.52,0.0
A13890,0,2,0,2,0.0,1.0,0.0
A13891,372,399,8,779,0.48,0.51,0.01
A13892,1,8,0,9,0.11,0.89,0.0
A13893,0,5,1,6,0.0,0.83,0.17
A13894,1,5,0,6,0.17,0.83,0.0
A13895,0,1,0,1,0.0,1.0,0.0
A13896,1,3,0,4,0.25,0.75,0.0
A13898,19,33,0,52,0.37,0.63,0.0
A13900,10,10,0,20,0.5,0.5,0.0
A13902,9,12,0,21,0.43,0.57,0.0
A13903,0,1,0,1,0.0,1.0,0.0
A13904,0,0,4,4,0.0,0.0,1.0
A13906,0,2,2,4,0.0,0.5,0.5
A13907,0,2,0,2,0.0,1.0,0.0
A13908,0,6,0,6,0.0,1.0,0.0
A13913,1,0,0,1,1.0,0.0,0.0
A13914,1,5,0,6,0.17,0.83,0.0
A13915,0,7,0,7,0.0,1.0,0.0
A13916,1,0,0,1,1.0,0.0,0.0
A13918,27,45,0,72,0.38,0.62,0.0
A13925,2,10,0,12,0.17,0.83,0.0
A13927,30,9,1,40,0.75,0.23,0.03
A13928,1,3,0,4,0.25,0.75,0.0
A13929,6,3,2,11,0.55,0.27,0.18
A13930,5,2,0,7,0.71,0.29,0.0
A13931,3,4,0,7,0.43,0.57,0.0
A13932,4,5,0,9,0.44,0.56,0.0
A13933,7,4,0,11,0.64,0.36,0.0
A13938,45,97,1,143,0.31,0.68,0.01
A13940,6,6,1,13,0.46,0.46,0.08
A13942,0,1,0,1,0.0,1.0,0.0
A13946,0,1,0,1,0.0,1.0,0.0
A13947,0,1,1,2,0.0,0.5,0.5
A13949,0,1,0,1,0.0,1.0,0.0
A13950,0,1,0,1,0.0,1.0,0.0
A13952,0,1,0,1,0.0,1.0,0.0
A13953,47,25,0,72,0.65,0.35,0.0
A13954,6,19,0,25,0.24,0.76,0.0
A13956,0,1,0,1,0.0,1.0,0.0
A13958,10,4,0,14,0.71,0.29,0.0
A13959,3,2,0,5,0.6,0.4,0.0
A13961,0,2,0,2,0.0,1.0,0.0
A13962,0,2,0,2,0.0,1.0,0.0
A13964,2,8,0,10,0.2,0.8,0.0
A13966,0,1,0,1,0.0,1.0,0.0
A13968,0,0,1,1,0.0,0.0,1.0
A13969,1,1,1,3,0.33,0.33,0.33
A13970,7,3,0,10,0.7,0.3,0.0
A13971,1,0,0,1,1.0,0.0,0.0
A13972,2,1,0,3,0.67,0.33,0.0
A13973,0,3,0,3,0.0,1.0,0.0
A13974,5,2,0,7,0.71,0.29,0.0
A13980,9,15,0,24,0.38,0.62,0.0
A13981,2,6,0,8,0.25,0.75,0.0
A13982,0,3,0,3,0.0,1.0,0.0
A13984,1,1,0,2,0.5,0.5,0.0
A13988,2,2,1,5,0.4,0.4,0.2
A13989,1,3,0,4,0.25,0.75,0.0
A13990,253,361,8,622,0.41,0.58,0.01
A13991,7,6,0,13,0.54,0.46,0.0
A13992,1,5,0,6,0.17,0.83,0.0
A13993,0,4,0,4,0.0,1.0,0.0
A13994,7,36,1,44,0.16,0.82,0.02
A13995,1,1,0,2,0.5,0.5,0.0
A13996,0,1,0,1,0.0,1.0,0.0
A13997,1,0,0,1,1.0,0.0,0.0
A13998,1,2,0,3,0.33,0.67,0.0
A13999,0,1,1,2,0.0,0.5,0.5
A14001,0,2,1,3,0.0,0.67,0.33
A14002,7,14,0,21,0.33,0.67,0.0
A14003,1,2,0,3,0.33,0.67,0.0
A14005,0,1,0,1,0.0,1.0,0.0
A14006,0,18,0,18,0.0,1.0,0.0
A14013,10,36,0,46,0.22,0.78,0.0
A14014,1,1,0,2,0.5,0.5,0.0
A14016,1,0,0,1,1.0,0.0,0.0
A14017,1,0,1,2,0.5,0.0,0.5
A14018,4,3,0,7,0.57,0.43,0.0
A14020,13,26,0,39,0.33,0.67,0.0
A14021,6,13,0,19,0.32,0.68,0.0
A14022,1,0,0,1,1.0,0.0,0.0
A14023,3,0,0,3,1.0,0.0,0.0
A14024,3,0,0,3,1.0,0.0,0.0
A14026,4,9,0,13,0.31,0.69,0.0
A14027,1,7,0,8,0.12,0.88,0.0
A14028,15,30,0,45,0.33,0.67,0.0
A14029,2,20,0,22,0.09,0.91,0.0
A14030,0,1,0,1,0.0,1.0,0.0
A14033,3,15,0,18,0.17,0.83,0.0
A14034,9,6,0,15,0.6,0.4,0.0
A14035,0,7,0,7,0.0,1.0,0.0
A14036,14,7,0,21,0.67,0.33,0.0
A14037,9,16,0,25,0.36,0.64,0.0
A14038,2,0,0,2,1.0,0.0,0.0
A14039,10,14,3,27,0.37,0.52,0.11
A14040,6,5,0,11,0.55,0.45,0.0
A14041,16,5,0,21,0.76,0.24,0.0
A14042,7,1,0,8,0.88,0.12,0.0
A14043,12,8,1,21,0.57,0.38,0.05
A14044,7,1,0,8,0.88,0.12,0.0
A14045,6,5,0,11,0.55,0.45,0.0
A14046,2,6,0,8,0.25,0.75,0.0
A14047,3,6,0,9,0.33,0.67,0.0
A14048,2,2,0,4,0.5,0.5,0.0
A14052,0,10,0,10,0.0,1.0,0.0
A14053,3,4,0,7,0.43,0.57,0.0
A14054,0,2,0,2,0.0,1.0,0.0
A14056,1,10,0,11,0.09,0.91,0.0
A14057,2,10,0,12,0.17,0.83,0.0
A14058,5,11,0,16,0.31,0.69,0.0
A14059,30,29,0,59,0.51,0.49,0.0
A14062,1,2,0,3,0.33,0.67,0.0
A14063,41,39,0,80,0.51,0.49,0.0
A14064,4,15,1,20,0.2,0.75,0.05
A14065,8,30,5,43,0.19,0.7,0.12
A14066,6,9,27,42,0.14,0.21,0.64
A14067,7,18,0,25,0.28,0.72,0.0
A14068,1,5,0,6,0.17,0.83,0.0
A14069,0,3,0,3,0.0,1.0,0.0
A14070,3,2,2,7,0.43,0.29,0.29
A14071,1,4,0,5,0.2,0.8,0.0
A14072,5,2,0,7,0.71,0.29,0.0
A14075,8,1,0,9,0.89,0.11,0.0
A14076,14,9,0,23,0.61,0.39,0.0
A14077,0,3,0,3,0.0,1.0,0.0
A14079,2,2,0,4,0.5,0.5,0.0
A14081,11,9,0,20,0.55,0.45,0.0
A14082,0,1,0,1,0.0,1.0,0.0
A14083,4,5,1,10,0.4,0.5,0.1
A14084,0,5,0,5,0.0,1.0,0.0
A14085,0,6,0,6,0.0,1.0,0.0
A14086,4,1,7,12,0.33,0.08,0.58
A14087,9,5,8,22,0.41,0.23,0.36
A14088,6,7,1,14,0.43,0.5,0.07
A14089,1,0,0,1,1.0,0.0,0.0
A14091,3,5,0,8,0.38,0.62,0.0
A14092,6,11,0,17,0.35,0.65,0.0
A14093,0,1,0,1,0.0,1.0,0.0
A14095,1,3,1,5,0.2,0.6,0.2
A14096,2,4,0,6,0.33,0.67,0.0
A14097,7,3,0,10,0.7,0.3,0.0
A14098,0,1,0,1,0.0,1.0,0.0
A14100,2,9,0,11,0.18,0.82,0.0
A14101,2,4,0,6,0.33,0.67,0.0
A14102,0,1,0,1,0.0,1.0,0.0
A14103,0,2,0,2,0.0,1.0,0.0
A14104,1,1,1,3,0.33,0.33,0.33
A14105,11,14,0,25,0.44,0.56,0.0
A14106,1,0,4,5,0.2,0.0,0.8
A14107,11,18,0,29,0.38,0.62,0.0
A14108,1,0,0,1,1.0,0.0,0.0
A14110,7,13,0,20,0.35,0.65,0.0
A14111,36,91,0,127,0.28,0.72,0.0
A14112,0,2,0,2,0.0,1.0,0.0
A14113,0,4,0,4,0.0,1.0,0.0
A14114,8,8,0,16,0.5,0.5,0.0
A14116,7,21,0,28,0.25,0.75,0.0
A14117,3,5,0,8,0.38,0.62,0.0
A14118,3,3,0,6,0.5,0.5,0.0
A14119,2,0,0,2,1.0,0.0,0.0
A14120,5,12,0,17,0.29,0.71,0.0
A14121,1,7,0,8,0.12,0.88,0.0
A14122,1,4,0,5,0.2,0.8,0.0
A14123,0,1,0,1,0.0,1.0,0.0
A14124,12,6,0,18,0.67,0.33,0.0
A14125,0,1,0,1,0.0,1.0,0.0
A14126,1,12,0,13,0.08,0.92,0.0
A14127,4,7,1,12,0.33,0.58,0.08
A14128,6,10,0,16,0.38,0.62,0.0
A14129,83,27,6,116,0.72,0.23,0.05
A14130,0,4,0,4,0.0,1.0,0.0
A14131,2,15,0,17,0.12,0.88,0.0
A14133,1,8,0,9,0.11,0.89,0.0
A14134,10,6,0,16,0.62,0.38,0.0
A14135,7,13,0,20,0.35,0.65,0.0
A14136,5,2,10,17,0.29,0.12,0.59
A14137,0,1,2,3,0.0,0.33,0.67
A14138,22,20,0,42,0.52,0.48,0.0
A14139,6,9,1,16,0.38,0.56,0.06
A14140,5,3,0,8,0.62,0.38,0.0
A14143,10,5,3,18,0.56,0.28,0.17
A14144,4,0,0,4,1.0,0.0,0.0
A14145,4,15,2,21,0.19,0.71,0.1
A14146,11,6,0,17,0.65,0.35,0.0
A14147,6,1,0,7,0.86,0.14,0.0
A14148,3,16,0,19,0.16,0.84,0.0
A14149,4,8,0,12,0.33,0.67,0.0
A14150,0,1,0,1,0.0,1.0,0.0
A14151,1,3,0,4,0.25,0.75,0.0
A14153,0,1,0,1,0.0,1.0,0.0
A14154,4,59,0,63,0.06,0.94,0.0
A14156,2,3,0,5,0.4,0.6,0.0
A14157,0,9,0,9,0.0,1.0,0.0
A14158,4,5,0,9,0.44,0.56,0.0
A14160,1,7,0,8,0.12,0.88,0.0
A14161,2,2,0,4,0.5,0.5,0.0
A14162,1,1,0,2,0.5,0.5,0.0
A14163,1,0,0,1,1.0,0.0,0.0
A14164,5,8,0,13,0.38,0.62,0.0
A14165,0,2,0,2,0.0,1.0,0.0
A14166,0,8,0,8,0.0,1.0,0.0
A14167,2,13,0,15,0.13,0.87,0.0
A14168,6,7,1,14,0.43,0.5,0.07
A14169,42,28,0,70,0.6,0.4,0.0
A14170,3,5,0,8,0.38,0.62,0.0
A14171,7,11,0,18,0.39,0.61,0.0
A14172,3,0,0,3,1.0,0.0,0.0
A14173,1,2,0,3,0.33,0.67,0.0
A14174,0,5,0,5,0.0,1.0,0.0
A14175,14,8,0,22,0.64,0.36,0.0
A14176,0,4,0,4,0.0,1.0,0.0
A14177,0,1,0,1,0.0,1.0,0.0
A14178,2,8,0,10,0.2,0.8,0.0
A14179,6,11,4,21,0.29,0.52,0.19
A14180,6,13,0,19,0.32,0.68,0.0
A14181,15,14,0,29,0.52,0.48,0.0
A14182,4,6,0,10,0.4,0.6,0.0
A14184,1,48,0,49,0.02,0.98,0.0
A14185,20,9,0,29,0.69,0.31,0.0
A14186,6,7,0,13,0.46,0.54,0.0
A14188,0,1,0,1,0.0,1.0,0.0
A14189,0,3,0,3,0.0,1.0,0.0
A14190,6,6,0,12,0.5,0.5,0.0
A14191,1,3,0,4,0.25,0.75,0.0
A14194,2,3,0,5,0.4,0.6,0.0
A14195,19,114,0,133,0.14,0.86,0.0
A14196,42,25,0,67,0.63,0.37,0.0
A14197,18,38,0,56,0.32,0.68,0.0
A14198,15,20,0,35,0.43,0.57,0.0
A14199,0,1,1,2,0.0,0.5,0.5
A14200,2,9,0,11,0.18,0.82,0.0
A14201,1,5,2,8,0.12,0.62,0.25
A14202,1,1,0,2,0.5,0.5,0.0
A14203,1,0,0,1,1.0,0.0,0.0
A14205,1,0,0,1,1.0,0.0,0.0
A14206,5,5,0,10,0.5,0.5,0.0
A14209,2,4,0,6,0.33,0.67,0.0
A14210,5,6,0,11,0.45,0.55,0.0
A14211,0,1,0,1,0.0,1.0,0.0
A14212,6,3,0,9,0.67,0.33,0.0
A14213,3,3,0,6,0.5,0.5,0.0
A14214,11,15,0,26,0.42,0.58,0.0
A14215,8,7,1,16,0.5,0.44,0.06
A14216,5,8,0,13,0.38,0.62,0.0
A14217,3,2,9,14,0.21,0.14,0.64
A14219,5,3,0,8,0.62,0.38,0.0
A14221,2,5,0,7,0.29,0.71,0.0
A14222,11,8,0,19,0.58,0.42,0.0
A14223,17,28,0,45,0.38,0.62,0.0
A14224,0,6,0,6,0.0,1.0,0.0
A14225,5,7,1,13,0.38,0.54,0.08
A14226,1,3,0,4,0.25,0.75,0.0
A14227,3,1,0,4,0.75,0.25,0.0
A14228,4,3,0,7,0.57,0.43,0.0
A14229,1,5,0,6,0.17,0.83,0.0
A14230,4,4,0,8,0.5,0.5,0.0
A14231,3,7,0,10,0.3,0.7,0.0
A14232,13,16,4,33,0.39,0.48,0.12
A14233,4,10,0,14,0.29,0.71,0.0
A14234,22,11,0,33,0.67,0.33,0.0
A14235,12,35,1,48,0.25,0.73,0.02
A14236,15,35,0,50,0.3,0.7,0.0
A14237,10,7,0,17,0.59,0.41,0.0
A14238,4,11,0,15,0.27,0.73,0.0
A14240,1,0,2,3,0.33,0.0,0.67
A14241,12,4,37,53,0.23,0.08,0.7
A14242,1,1,0,2,0.5,0.5,0.0
A14243,2,3,1,6,0.33,0.5,0.17
A14244,27,27,2,56,0.48,0.48,0.04
A14245,6,18,1,25,0.24,0.72,0.04
A14246,3,5,0,8,0.38,0.62,0.0
A14247,48,22,3,73,0.66,0.3,0.04
A14248,0,1,0,1,0.0,1.0,0.0
A14249,591,815,86,1492,0.4,0.55,0.06
A14250,8,8,0,16,0.5,0.5,0.0
A14251,7,31,0,38,0.18,0.82,0.0
A14252,9,68,1,78,0.12,0.87,0.01
A14253,27,212,1,240,0.11,0.88,0.0
A14254,7,7,10,24,0.29,0.29,0.42
A14255,99,79,22,200,0.49,0.4,0.11
A14256,29,46,6,81,0.36,0.57,0.07
A14257,11,32,0,43,0.26,0.74,0.0
A14258,15,15,0,30,0.5,0.5,0.0
A14259,16,27,5,48,0.33,0.56,0.1
A14260,56,49,2,107,0.52,0.46,0.02
A14261,20,16,1,37,0.54,0.43,0.03
A14262,30,25,4,59,0.51,0.42,0.07
A14263,6,8,0,14,0.43,0.57,0.0
A14264,12,14,0,26,0.46,0.54,0.0
A14265,8,14,0,22,0.36,0.64,0.0
A14266,0,2,5,7,0.0,0.29,0.71
A14267,10,13,0,23,0.43,0.57,0.0
A14268,15,27,0,42,0.36,0.64,0.0
A14269,16,18,4,38,0.42,0.47,0.11
A14270,13,11,0,24,0.54,0.46,0.0
A14271,6,11,0,17,0.35,0.65,0.0
A14272,10,17,0,27,0.37,0.63,0.0
A14273,15,15,4,34,0.44,0.44,0.12
A14274,8,19,0,27,0.3,0.7,0.0
A14275,4,9,0,13,0.31,0.69,0.0
A14276,7,9,0,16,0.44,0.56,0.0
A14277,8,7,1,16,0.5,0.44,0.06
A14278,6,7,0,13,0.46,0.54,0.0
A14279,10,10,1,21,0.48,0.48,0.05
A14280,14,21,0,35,0.4,0.6,0.0
A14281,11,21,0,32,0.34,0.66,0.0
A14282,0,1,0,1,0.0,1.0,0.0
A14283,36,53,6,95,0.38,0.56,0.06
A14284,4,3,0,7,0.57,0.43,0.0
A14286,46,34,3,83,0.55,0.41,0.04
A14287,26,17,2,45,0.58,0.38,0.04
A14288,0,5,0,5,0.0,1.0,0.0
A14289,33,26,0,59,0.56,0.44,0.0
A14290,12,15,0,27,0.44,0.56,0.0
A14291,7,15,0,22,0.32,0.68,0.0
A14292,5,10,0,15,0.33,0.67,0.0
A14293,39,25,1,65,0.6,0.38,0.02
A14294,20,19,0,39,0.51,0.49,0.0
A14295,8,11,0,19,0.42,0.58,0.0
A14296,9,7,0,16,0.56,0.44,0.0
A14297,46,24,0,70,0.66,0.34,0.0
A14298,18,20,5,43,0.42,0.47,0.12
A14299,3,5,2,10,0.3,0.5,0.2
A14300,6,10,0,16,0.38,0.62,0.0
A14301,3,1,0,4,0.75,0.25,0.0
A14302,12,15,3,30,0.4,0.5,0.1
A14303,1,0,0,1,1.0,0.0,0.0
A14304,193,104,1,298,0.65,0.35,0.0
A14305,9,5,0,14,0.64,0.36,0.0
A14306,6,2,5,13,0.46,0.15,0.38
A14307,10,18,0,28,0.36,0.64,0.0
A14308,8,6,2,16,0.5,0.38,0.12
A14309,7,7,1,15,0.47,0.47,0.07
A14310,123,25,53,201,0.61,0.12,0.26
A14311,146,49,2,197,0.74,0.25,0.01
A14312,0,2,0,2,0.0,1.0,0.0
A14313,32,24,1,57,0.56,0.42,0.02
A14314,44,35,3,82,0.54,0.43,0.04
A14315,15,17,0,32,0.47,0.53,0.0
A14316,27,10,0,37,0.73,0.27,0.0
A14317,4,8,0,12,0.33,0.67,0.0
A14318,27,24,9,60,0.45,0.4,0.15
A14319,46,8,1,55,0.84,0.15,0.02
A14320,4,17,0,21,0.19,0.81,0.0
A14321,39,28,0,67,0.58,0.42,0.0
A14322,1,2,1,4,0.25,0.5,0.25
A14323,11,9,0,20,0.55,0.45,0.0
A14324,10,6,0,16,0.62,0.38,0.0
A14325,3,11,0,14,0.21,0.79,0.0
A14326,0,2,0,2,0.0,1.0,0.0
A14327,5,8,0,13,0.38,0.62,0.0
A14328,2,2,0,4,0.5,0.5,0.0
A14329,1,9,0,10,0.1,0.9,0.0
A14330,0,2,0,2,0.0,1.0,0.0
A14331,2,26,0,28,0.07,0.93,0.0
A14332,3,6,0,9,0.33,0.67,0.0
A14333,20,4,31,55,0.36,0.07,0.56
A14334,10,5,0,15,0.67,0.33,0.0
A14335,0,2,0,2,0.0,1.0,0.0
A14336,2,10,2,14,0.14,0.71,0.14
A14337,5,8,0,13,0.38,0.62,0.0
A14338,5,3,10,18,0.28,0.17,0.56
A14339,29,14,11,54,0.54,0.26,0.2
A14340,4,5,0,9,0.44,0.56,0.0
A14341,2,8,0,10,0.2,0.8,0.0
A14342,13,9,2,24,0.54,0.38,0.08
A14344,43,28,1,72,0.6,0.39,0.01
A14345,4,4,0,8,0.5,0.5,0.0
A14346,2,9,0,11,0.18,0.82,0.0
A14347,82,19,0,101,0.81,0.19,0.0
A14348,1,8,0,9,0.11,0.89,0.0
A14349,16,9,1,26,0.62,0.35,0.04
A14350,2,4,0,6,0.33,0.67,0.0
A14351,21,28,0,49,0.43,0.57,0.0
A14353,5,4,1,10,0.5,0.4,0.1
A14354,5,2,0,7,0.71,0.29,0.0
A14355,12,4,4,20,0.6,0.2,0.2
A14356,6,16,0,22,0.27,0.73,0.0
A14357,1,3,0,4,0.25,0.75,0.0
A14358,4,4,0,8,0.5,0.5,0.0
A14359,2,3,0,5,0.4,0.6,0.0
A14360,19,5,0,24,0.79,0.21,0.0
A14362,12,10,0,22,0.55,0.45,0.0
A14363,28,10,0,38,0.74,0.26,0.0
A14364,1,5,0,6,0.17,0.83,0.0
A14365,17,7,0,24,0.71,0.29,0.0
A14366,29,12,0,41,0.71,0.29,0.0
A14367,4,5,0,9,0.44,0.56,0.0
A14368,9,62,0,71,0.13,0.87,0.0
A14369,1,15,0,16,0.06,0.94,0.0
A14370,58,20,0,78,0.74,0.26,0.0
A14371,10,23,0,33,0.3,0.7,0.0
A14372,3,3,0,6,0.5,0.5,0.0
A14374,4,20,0,24,0.17,0.83,0.0
A14375,16,45,0,61,0.26,0.74,0.0
A14376,2,8,0,10,0.2,0.8,0.0
A14377,41,56,0,97,0.42,0.58,0.0
A14378,2,6,0,8,0.25,0.75,0.0
A14379,40,23,2,65,0.62,0.35,0.03
A14380,1,9,0,10,0.1,0.9,0.0
A14382,22,81,0,103,0.21,0.79,0.0
A14383,17,8,0,25,0.68,0.32,0.0
A14384,0,5,0,5,0.0,1.0,0.0
A14385,2,6,0,8,0.25,0.75,0.0
A14386,0,5,0,5,0.0,1.0,0.0
A14387,16,31,1,48,0.33,0.65,0.02
A14388,6,23,0,29,0.21,0.79,0.0
A14389,15,14,2,31,0.48,0.45,0.06
A14390,11,10,0,21,0.52,0.48,0.0
A14391,1,3,0,4,0.25,0.75,0.0
A14392,3,17,0,20,0.15,0.85,0.0
A14393,3,16,0,19,0.16,0.84,0.0
A14394,2,13,0,15,0.13,0.87,0.0
A14395,5,2,0,7,0.71,0.29,0.0
A14396,2,2,0,4,0.5,0.5,0.0
A14397,4,4,0,8,0.5,0.5,0.0
A14399,0,1,0,1,0.0,1.0,0.0
A14400,0,1,0,1,0.0,1.0,0.0
A14401,6,6,0,12,0.5,0.5,0.0
A14403,29,33,0,62,0.47,0.53,0.0
A14404,47,23,0,70,0.67,0.33,0.0
A14405,1,3,0,4,0.25,0.75,0.0
A14406,0,1,0,1,0.0,1.0,0.0
A14409,28,25,0,53,0.53,0.47,0.0
A14410,0,0,2,2,0.0,0.0,1.0
A14412,8,38,0,46,0.17,0.83,0.0
A14413,1,2,0,3,0.33,0.67,0.0
A14414,13,15,1,29,0.45,0.52,0.03
A14415,6,12,0,18,0.33,0.67,0.0
A14416,5,11,0,16,0.31,0.69,0.0
A14417,20,12,4,36,0.56,0.33,0.11
A14418,1,2,0,3,0.33,0.67,0.0
A14419,4,5,1,10,0.4,0.5,0.1
A14420,6,3,0,9,0.67,0.33,0.0
A14421,18,20,1,39,0.46,0.51,0.03
A14422,7,13,0,20,0.35,0.65,0.0
A14423,7,6,13,26,0.27,0.23,0.5
A14424,4,4,0,8,0.5,0.5,0.0
A14425,7,19,1,27,0.26,0.7,0.04
A14426,8,28,0,36,0.22,0.78,0.0
A14427,0,2,0,2,0.0,1.0,0.0
A14428,45,12,1,58,0.78,0.21,0.02
A14429,0,6,0,6,0.0,1.0,0.0
A14431,67,13,4,84,0.8,0.15,0.05
A14432,3,17,0,20,0.15,0.85,0.0
A14433,20,33,1,54,0.37,0.61,0.02
A14434,81,215,3,299,0.27,0.72,0.01
A14435,4,1,18,23,0.17,0.04,0.78
A14436,2,5,0,7,0.29,0.71,0.0
A14437,6,30,0,36,0.17,0.83,0.0
A14438,0,6,0,6,0.0,1.0,0.0
A14439,1,9,0,10,0.1,0.9,0.0
A14440,15,24,0,39,0.38,0.62,0.0
A14441,51,46,0,97,0.53,0.47,0.0
A14442,6,19,0,25,0.24,0.76,0.0
A14443,76,33,1,110,0.69,0.3,0.01
A14444,11,11,0,22,0.5,0.5,0.0
A14445,2,1,0,3,0.67,0.33,0.0
A14446,3,10,0,13,0.23,0.77,0.0
A14447,39,18,1,58,0.67,0.31,0.02
A14448,16,92,0,108,0.15,0.85,0.0
A14450,23,17,4,44,0.52,0.39,0.09
A14451,23,10,0,33,0.7,0.3,0.0
A14452,3,2,0,5,0.6,0.4,0.0
A14453,29,21,0,50,0.58,0.42,0.0
A14454,8,15,1,24,0.33,0.62,0.04
A14455,3,5,0,8,0.38,0.62,0.0
A14456,8,13,0,21,0.38,0.62,0.0
A14457,1,20,0,21,0.05,0.95,0.0
A14458,7,8,0,15,0.47,0.53,0.0
A14459,20,18,0,38,0.53,0.47,0.0
A14460,14,9,0,23,0.61,0.39,0.0
A14461,6,6,0,12,0.5,0.5,0.0
A14462,6,6,0,12,0.5,0.5,0.0
A14463,2,1,0,3,0.67,0.33,0.0
A14465,21,36,0,57,0.37,0.63,0.0
A14466,5,7,0,12,0.42,0.58,0.0
A14467,5,6,0,11,0.45,0.55,0.0
A14468,0,1,0,1,0.0,1.0,0.0
A14469,8,11,2,21,0.38,0.52,0.1
A14470,3,2,0,5,0.6,0.4,0.0
A14471,1,8,0,9,0.11,0.89,0.0
A14472,1,1,0,2,0.5,0.5,0.0
A14473,7,11,0,18,0.39,0.61,0.0
A14474,7,6,0,13,0.54,0.46,0.0
A14475,7,19,2,28,0.25,0.68,0.07
A14476,7,2,0,9,0.78,0.22,0.0
A14477,3,12,0,15,0.2,0.8,0.0
A14478,7,2,0,9,0.78,0.22,0.0
A14479,1,10,0,11,0.09,0.91,0.0
A14481,1,3,0,4,0.25,0.75,0.0
A14482,15,43,2,60,0.25,0.72,0.03
A14483,34,39,2,75,0.45,0.52,0.03
A14484,2,5,0,7,0.29,0.71,0.0
A14485,6,12,0,18,0.33,0.67,0.0
A14486,1,5,0,6,0.17,0.83,0.0
A14487,6,6,0,12,0.5,0.5,0.0
A14488,8,7,0,15,0.53,0.47,0.0
A14489,0,1,0,1,0.0,1.0,0.0
A14490,0,6,0,6,0.0,1.0,0.0
A14491,0,4,0,4,0.0,1.0,0.0
A14492,0,5,0,5,0.0,1.0,0.0
A14493,7,18,0,25,0.28,0.72,0.0
A14494,47,34,3,84,0.56,0.4,0.04
A14495,3,3,1,7,0.43,0.43,0.14
A14497,6,17,0,23,0.26,0.74,0.0
A14498,7,14,0,21,0.33,0.67,0.0
A14499,67,40,22,129,0.52,0.31,0.17
A14500,7,14,0,21,0.33,0.67,0.0
A14501,16,13,0,29,0.55,0.45,0.0
A14502,0,2,0,2,0.0,1.0,0.0
A14504,29,16,1,46,0.63,0.35,0.02
A14506,11,10,0,21,0.52,0.48,0.0
A14507,2,3,0,5,0.4,0.6,0.0
A14508,3,10,0,13,0.23,0.77,0.0
A14509,4,8,0,12,0.33,0.67,0.0
A14510,2,9,1,12,0.17,0.75,0.08
A14511,0,13,0,13,0.0,1.0,0.0
A14512,5,3,0,8,0.62,0.38,0.0
A14513,13,19,2,34,0.38,0.56,0.06
A14514,3,20,1,24,0.12,0.83,0.04
A14515,4,8,0,12,0.33,0.67,0.0
A14516,1,6,0,7,0.14,0.86,0.0
A14517,3,4,2,9,0.33,0.44,0.22
A14520,3,4,0,7,0.43,0.57,0.0
A14521,6,14,0,20,0.3,0.7,0.0
A14522,0,1,0,1,0.0,1.0,0.0
A14523,1,5,0,6,0.17,0.83,0.0
A14524,23,9,0,32,0.72,0.28,0.0
A14525,8,9,0,17,0.47,0.53,0.0
A14526,2,1,0,3,0.67,0.33,0.0
A14527,10,9,0,19,0.53,0.47,0.0
A14528,0,2,3,5,0.0,0.4,0.6
A14529,25,19,0,44,0.57,0.43,0.0
A14530,4,6,0,10,0.4,0.6,0.0
A14531,2,24,0,26,0.08,0.92,0.0
A14532,1,2,0,3,0.33,0.67,0.0
A14533,0,1,0,1,0.0,1.0,0.0
A14534,3,15,0,18,0.17,0.83,0.0
A14535,358,624,14,996,0.36,0.63,0.01
A14536,0,1,0,1,0.0,1.0,0.0
A14537,3,6,0,9,0.33,0.67,0.0
A14538,3,6,0,9,0.33,0.67,0.0
A14540,12,8,0,20,0.6,0.4,0.0
A14541,2,0,2,4,0.5,0.0,0.5
A14542,4,3,0,7,0.57,0.43,0.0
A14543,1,5,0,6,0.17,0.83,0.0
A14544,2,7,0,9,0.22,0.78,0.0
A14545,18,24,0,42,0.43,0.57,0.0
A14546,15,12,0,27,0.56,0.44,0.0
A14547,6,9,1,16,0.38,0.56,0.06
A14548,2,13,0,15,0.13,0.87,0.0
A14549,2,0,0,2,1.0,0.0,0.0
A14550,0,6,0,6,0.0,1.0,0.0
A14551,1,2,0,3,0.33,0.67,0.0
A14552,0,2,0,2,0.0,1.0,0.0
A14553,3,2,0,5,0.6,0.4,0.0
A14554,0,1,0,1,0.0,1.0,0.0
A14556,0,1,0,1,0.0,1.0,0.0
A14557,3,6,0,9,0.33,0.67,0.0
A14558,9,10,0,19,0.47,0.53,0.0
A14560,4,2,0,6,0.67,0.33,0.0
A14561,6,7,0,13,0.46,0.54,0.0
A14562,1,3,1,5,0.2,0.6,0.2
A14563,2,4,0,6,0.33,0.67,0.0
A14564,6,11,0,17,0.35,0.65,0.0
A14566,2,17,0,19,0.11,0.89,0.0
A14567,11,18,0,29,0.38,0.62,0.0
A14568,1,5,0,6,0.17,0.83,0.0
A14569,2,3,0,5,0.4,0.6,0.0
A14570,1,0,0,1,1.0,0.0,0.0
A14571,2,4,0,6,0.33,0.67,0.0
A14572,0,2,0,2,0.0,1.0,0.0
A14573,0,3,0,3,0.0,1.0,0.0
A14574,4,18,0,22,0.18,0.82,0.0
A14575,0,1,2,3,0.0,0.33,0.67
A14576,9,34,0,43,0.21,0.79,0.0
A14577,2,10,0,12,0.17,0.83,0.0
A14578,0,3,0,3,0.0,1.0,0.0
A14579,4,4,0,8,0.5,0.5,0.0
A14580,312,596,17,925,0.34,0.64,0.02
A14581,8,28,0,36,0.22,0.78,0.0
A14582,10,18,0,28,0.36,0.64,0.0
A14583,8,12,2,22,0.36,0.55,0.09
A14584,0,1,0,1,0.0,1.0,0.0
A14585,0,1,0,1,0.0,1.0,0.0
A14586,1,1,0,2,0.5,0.5,0.0
A14587,29,14,0,43,0.67,0.33,0.0
A14588,9,7,0,16,0.56,0.44,0.0
A14589,7,16,1,24,0.29,0.67,0.04
A14590,4,6,2,12,0.33,0.5,0.17
A14592,40,14,0,54,0.74,0.26,0.0
A14594,7,9,0,16,0.44,0.56,0.0
A14595,5,19,0,24,0.21,0.79,0.0
A14596,1,2,0,3,0.33,0.67,0.0
A14597,7,21,0,28,0.25,0.75,0.0
A14598,7,9,0,16,0.44,0.56,0.0
A14603,1,1,1,3,0.33,0.33,0.33
A14604,0,6,0,6,0.0,1.0,0.0
A14605,7,4,0,11,0.64,0.36,0.0
A14606,1,5,2,8,0.12,0.62,0.25
A14607,15,12,0,27,0.56,0.44,0.0
A14608,2,0,0,2,1.0,0.0,0.0
A14609,76,21,2,99,0.77,0.21,0.02
A14610,1,2,0,3,0.33,0.67,0.0
A14612,2,5,0,7,0.29,0.71,0.0
A14613,9,15,0,24,0.38,0.62,0.0
A14614,0,1,0,1,0.0,1.0,0.0
A14616,3,35,0,38,0.08,0.92,0.0
A14617,11,5,0,16,0.69,0.31,0.0
A14618,5,0,0,5,1.0,0.0,0.0
A14620,2,4,0,6,0.33,0.67,0.0
A14621,0,1,0,1,0.0,1.0,0.0
A14625,1,1,0,2,0.5,0.5,0.0
A14626,90,31,13,134,0.67,0.23,0.1
A14628,3,0,0,3,1.0,0.0,0.0
A14629,1,2,0,3,0.33,0.67,0.0
A14630,6,4,0,10,0.6,0.4,0.0
A14632,5,0,0,5,1.0,0.0,0.0
A14633,0,1,0,1,0.0,1.0,0.0
A14634,0,2,0,2,0.0,1.0,0.0
A14635,1,1,0,2,0.5,0.5,0.0
A14637,0,1,0,1,0.0,1.0,0.0
A14640,1,0,1,2,0.5,0.0,0.5
A14643,2,1,1,4,0.5,0.25,0.25
A14644,0,1,0,1,0.0,1.0,0.0
A14645,14,17,2,33,0.42,0.52,0.06
A14646,1,0,8,9,0.11,0.0,0.89
A14647,14,5,0,19,0.74,0.26,0.0
A14648,2,2,2,6,0.33,0.33,0.33
A14649,1,1,0,2,0.5,0.5,0.0
A14650,4,7,0,11,0.36,0.64,0.0
A14654,0,16,0,16,0.0,1.0,0.0
A14656,0,10,0,10,0.0,1.0,0.0
A14660,1,2,0,3,0.33,0.67,0.0
A14661,0,2,0,2,0.0,1.0,0.0
A14664,0,3,0,3,0.0,1.0,0.0
A14666,0,3,0,3,0.0,1.0,0.0
A14667,3,2,0,5,0.6,0.4,0.0
A14668,1,1,1,3,0.33,0.33,0.33
A14671,0,1,0,1,0.0,1.0,0.0
A14672,0,1,0,1,0.0,1.0,0.0
A14675,0,3,0,3,0.0,1.0,0.0
A14677,0,2,0,2,0.0,1.0,0.0
A14680,0,2,0,2,0.0,1.0,0.0
A14681,0,2,1,3,0.0,0.67,0.33
A14684,13,4,0,17,0.76,0.24,0.0
A14686,1,0,0,1,1.0,0.0,0.0
A14687,3,4,0,7,0.43,0.57,0.0
A14689,5,4,3,12,0.42,0.33,0.25
A14692,4,3,0,7,0.57,0.43,0.0
A14693,0,4,0,4,0.0,1.0,0.0
A14694,0,2,0,2,0.0,1.0,0.0
A14695,2,5,0,7,0.29,0.71,0.0
A14699,8,14,4,26,0.31,0.54,0.15
A14700,17,16,1,34,0.5,0.47,0.03
A14701,0,3,0,3,0.0,1.0,0.0
A14702,0,2,0,2,0.0,1.0,0.0
A14703,6,8,0,14,0.43,0.57,0.0
A14704,0,2,0,2,0.0,1.0,0.0
A14708,0,1,0,1,0.0,1.0,0.0
A14709,3,4,0,7,0.43,0.57,0.0
A14710,1,0,1,2,0.5,0.0,0.5
A14712,3,2,0,5,0.6,0.4,0.0
A14713,2,6,0,8,0.25,0.75,0.0
A14714,2,0,0,2,1.0,0.0,0.0
A14715,1,1,0,2,0.5,0.5,0.0
A14716,14,4,3,21,0.67,0.19,0.14
A14718,1,5,0,6,0.17,0.83,0.0
A14719,1,0,0,1,1.0,0.0,0.0
A14722,1,2,0,3,0.33,0.67,0.0
A14723,9,16,0,25,0.36,0.64,0.0
A14724,0,2,0,2,0.0,1.0,0.0
A14725,8,8,0,16,0.5,0.5,0.0
A14726,1,7,0,8,0.12,0.88,0.0
A14727,7,6,0,13,0.54,0.46,0.0
A14729,12,13,1,26,0.46,0.5,0.04
A14730,11,3,0,14,0.79,0.21,0.0
A14731,2,3,0,5,0.4,0.6,0.0
A14732,2,1,0,3,0.67,0.33,0.0
A14733,36,21,0,57,0.63,0.37,0.0
A14734,1,2,0,3,0.33,0.67,0.0
A14735,1,4,0,5,0.2,0.8,0.0
A14736,1,4,0,5,0.2,0.8,0.0
A14737,1,0,0,1,1.0,0.0,0.0
A14738,0,2,0,2,0.0,1.0,0.0
A14740,4,4,0,8,0.5,0.5,0.0
A14743,2,1,0,3,0.67,0.33,0.0
A14745,35,20,0,55,0.64,0.36,0.0
A14746,0,2,0,2,0.0,1.0,0.0
A14748,2,1,0,3,0.67,0.33,0.0
A14749,9,6,0,15,0.6,0.4,0.0
A14750,28,17,0,45,0.62,0.38,0.0
A14751,3,11,0,14,0.21,0.79,0.0
A14752,0,2,0,2,0.0,1.0,0.0
A14753,0,1,0,1,0.0,1.0,0.0
A14754,3,16,0,19,0.16,0.84,0.0
A14756,1,3,0,4,0.25,0.75,0.0
A14757,22,23,0,45,0.49,0.51,0.0
A14759,3,15,0,18,0.17,0.83,0.0
A14760,0,5,0,5,0.0,1.0,0.0
A14761,0,4,0,4,0.0,1.0,0.0
A14763,3,1,11,15,0.2,0.07,0.73
A14764,32,10,0,42,0.76,0.24,0.0
A14767,2,4,0,6,0.33,0.67,0.0
A14768,0,2,0,2,0.0,1.0,0.0
A14769,8,5,0,13,0.62,0.38,0.0
A14770,2,3,0,5,0.4,0.6,0.0
A14771,1,0,0,1,1.0,0.0,0.0
A14772,1,1,0,2,0.5,0.5,0.0
A14773,1,6,0,7,0.14,0.86,0.0
A14774,2,3,0,5,0.4,0.6,0.0
A14775,14,7,0,21,0.67,0.33,0.0
A14776,9,7,0,16,0.56,0.44,0.0
A14777,2,4,0,6,0.33,0.67,0.0
A14778,3,14,1,18,0.17,0.78,0.06
A14779,0,5,0,5,0.0,1.0,0.0
A14780,9,27,0,36,0.25,0.75,0.0
A14781,15,7,0,22,0.68,0.32,0.0
A14782,0,1,0,1,0.0,1.0,0.0
A14783,0,5,0,5,0.0,1.0,0.0
A14784,1,5,0,6,0.17,0.83,0.0
A14785,6,9,0,15,0.4,0.6,0.0
A14787,4,0,0,4,1.0,0.0,0.0
A14788,7,4,3,14,0.5,0.29,0.21
A14789,8,1,0,9,0.89,0.11,0.0
A14790,2,3,0,5,0.4,0.6,0.0
A14791,69,43,1,113,0.61,0.38,0.01
A14792,0,2,0,2,0.0,1.0,0.0
A14793,6,21,0,27,0.22,0.78,0.0
A14794,3,12,0,15,0.2,0.8,0.0
A14795,1,2,0,3,0.33,0.67,0.0
A14796,0,1,0,1,0.0,1.0,0.0
A14797,2,2,0,4,0.5,0.5,0.0
A14798,3,3,0,6,0.5,0.5,0.0
A14799,5,15,0,20,0.25,0.75,0.0
A14800,7,8,0,15,0.47,0.53,0.0
A14801,8,11,0,19,0.42,0.58,0.0
A14802,5,7,0,12,0.42,0.58,0.0
A14803,4,0,0,4,1.0,0.0,0.0
A14804,9,13,0,22,0.41,0.59,0.0
A14805,6,9,0,15,0.4,0.6,0.0
A14806,49,24,0,73,0.67,0.33,0.0
A14807,0,3,0,3,0.0,1.0,0.0
A14808,1,0,0,1,1.0,0.0,0.0
A14809,1,5,0,6,0.17,0.83,0.0
A14811,18,24,0,42,0.43,0.57,0.0
A14813,1,6,0,7,0.14,0.86,0.0
A14815,46,19,2,67,0.69,0.28,0.03
A14816,0,12,0,12,0.0,1.0,0.0
A14818,3,4,0,7,0.43,0.57,0.0
A14819,0,2,0,2,0.0,1.0,0.0
A14821,0,1,0,1,0.0,1.0,0.0
A14823,1,0,0,1,1.0,0.0,0.0
A14824,2,1,0,3,0.67,0.33,0.0
A14825,1,2,11,14,0.07,0.14,0.79
A14826,4,7,0,11,0.36,0.64,0.0
A14827,2,5,0,7,0.29,0.71,0.0
A14828,1,4,0,5,0.2,0.8,0.0
A14829,0,3,1,4,0.0,0.75,0.25
A14830,22,10,0,32,0.69,0.31,0.0
A14831,0,1,0,1,0.0,1.0,0.0
A14832,19,17,0,36,0.53,0.47,0.0
A14833,1,3,0,4,0.25,0.75,0.0
A14835,2,8,0,10,0.2,0.8,0.0
A14836,0,1,0,1,0.0,1.0,0.0
A14837,6,11,2,19,0.32,0.58,0.11
A14838,0,2,0,2,0.0,1.0,0.0
A14839,0,2,0,2,0.0,1.0,0.0
A14840,2,3,0,5,0.4,0.6,0.0
A14841,5,6,0,11,0.45,0.55,0.0
A14846,21,15,0,36,0.58,0.42,0.0
A14847,35,85,0,120,0.29,0.71,0.0
A14848,2,7,0,9,0.22,0.78,0.0
A14850,4,7,0,11,0.36,0.64,0.0
A14851,8,24,0,32,0.25,0.75,0.0
A14852,0,2,0,2,0.0,1.0,0.0
A14853,0,3,0,3,0.0,1.0,0.0
A14854,1,3,3,7,0.14,0.43,0.43
A14855,9,4,0,13,0.69,0.31,0.0
A14856,1,0,0,1,1.0,0.0,0.0
A14858,33,94,0,127,0.26,0.74,0.0
A14859,4,5,0,9,0.44,0.56,0.0
A14860,6,14,0,20,0.3,0.7,0.0
A14861,5,17,0,22,0.23,0.77,0.0
A14862,11,21,0,32,0.34,0.66,0.0
A14863,3,10,0,13,0.23,0.77,0.0
A14864,24,11,3,38,0.63,0.29,0.08
A14865,7,7,0,14,0.5,0.5,0.0
A14866,4,24,0,28,0.14,0.86,0.0
A14867,10,5,0,15,0.67,0.33,0.0
A14868,3,5,0,8,0.38,0.62,0.0
A14869,12,16,0,28,0.43,0.57,0.0
A14870,0,1,0,1,0.0,1.0,0.0
A14871,4,7,1,12,0.33,0.58,0.08
A14872,4,7,0,11,0.36,0.64,0.0
A14873,8,11,0,19,0.42,0.58,0.0
A14874,17,21,0,38,0.45,0.55,0.0
A14875,0,3,1,4,0.0,0.75,0.25
A14876,3,5,0,8,0.38,0.62,0.0
A14877,31,18,2,51,0.61,0.35,0.04
A14878,2,3,0,5,0.4,0.6,0.0
A14880,22,5,0,27,0.81,0.19,0.0
A14881,3,6,2,11,0.27,0.55,0.18
A14883,0,7,0,7,0.0,1.0,0.0
A14884,11,11,0,22,0.5,0.5,0.0
A14885,0,1,0,1,0.0,1.0,0.0
A14886,321,457,39,817,0.39,0.56,0.05
A14888,5,3,2,10,0.5,0.3,0.2
A14889,13,17,0,30,0.43,0.57,0.0
A14890,19,15,1,35,0.54,0.43,0.03
A14891,23,36,0,59,0.39,0.61,0.0
A14892,6,6,1,13,0.46,0.46,0.08
A14893,7,11,0,18,0.39,0.61,0.0
A14894,3,8,0,11,0.27,0.73,0.0
A14895,23,30,3,56,0.41,0.54,0.05
A14896,3,19,0,22,0.14,0.86,0.0
A14897,0,1,0,1,0.0,1.0,0.0
A14898,21,12,0,33,0.64,0.36,0.0
A14899,21,22,3,46,0.46,0.48,0.07
A14900,0,1,0,1,0.0,1.0,0.0
A14902,1,6,0,7,0.14,0.86,0.0
A14903,22,9,1,32,0.69,0.28,0.03
A14904,1,2,1,4,0.25,0.5,0.25
A14906,36,47,3,86,0.42,0.55,0.03
A14907,0,4,0,4,0.0,1.0,0.0
A14908,25,12,0,37,0.68,0.32,0.0
A14909,10,4,0,14,0.71,0.29,0.0
A14910,15,15,0,30,0.5,0.5,0.0
A14911,1,4,0,5,0.2,0.8,0.0
A14913,61,28,1,90,0.68,0.31,0.01
A14914,2,5,0,7,0.29,0.71,0.0
A14915,24,19,1,44,0.55,0.43,0.02
A14916,1,3,0,4,0.25,0.75,0.0
A14917,2,3,0,5,0.4,0.6,0.0
A14920,26,21,1,48,0.54,0.44,0.02
A14921,3,3,0,6,0.5,0.5,0.0
A14922,0,2,0,2,0.0,1.0,0.0
A14923,0,3,0,3,0.0,1.0,0.0
A14924,2,7,0,9,0.22,0.78,0.0
A14925,7,3,0,10,0.7,0.3,0.0
A14926,0,1,0,1,0.0,1.0,0.0
A14927,7,3,0,10,0.7,0.3,0.0
A14928,1,1,0,2,0.5,0.5,0.0
A14929,26,19,0,45,0.58,0.42,0.0
A14930,0,1,0,1,0.0,1.0,0.0
A14931,0,1,0,1,0.0,1.0,0.0
A14932,9,3,0,12,0.75,0.25,0.0
A14933,5,8,0,13,0.38,0.62,0.0
A14934,32,7,0,39,0.82,0.18,0.0
A14935,1,0,0,1,1.0,0.0,0.0
A14936,14,20,0,34,0.41,0.59,0.0
A14937,0,1,0,1,0.0,1.0,0.0
A14938,0,1,0,1,0.0,1.0,0.0
A14939,3,0,0,3,1.0,0.0,0.0
A14940,19,28,0,47,0.4,0.6,0.0
A14941,2,3,0,5,0.4,0.6,0.0
A14942,3,2,0,5,0.6,0.4,0.0
A14943,7,3,0,10,0.7,0.3,0.0
A14945,10,18,0,28,0.36,0.64,0.0
A14946,4,11,0,15,0.27,0.73,0.0
A14947,4,8,0,12,0.33,0.67,0.0
A14948,12,13,0,25,0.48,0.52,0.0
A14949,2,5,0,7,0.29,0.71,0.0
A14950,8,12,0,20,0.4,0.6,0.0
A14951,21,13,0,34,0.62,0.38,0.0
A14953,8,3,0,11,0.73,0.27,0.0
A14954,0,2,0,2,0.0,1.0,0.0
A14955,12,4,4,20,0.6,0.2,0.2
A14956,1,6,0,7,0.14,0.86,0.0
A14957,6,6,0,12,0.5,0.5,0.0
A14958,5,9,0,14,0.36,0.64,0.0
A14959,5,8,0,13,0.38,0.62,0.0
A14960,0,2,0,2,0.0,1.0,0.0
A14961,1,6,0,7,0.14,0.86,0.0
A14962,18,18,0,36,0.5,0.5,0.0
A14963,9,7,0,16,0.56,0.44,0.0
A14964,1,2,1,4,0.25,0.5,0.25
A14965,10,9,0,19,0.53,0.47,0.0
A14966,21,14,40,75,0.28,0.19,0.53
A14967,22,20,5,47,0.47,0.43,0.11
A14969,3,3,0,6,0.5,0.5,0.0
A14970,4,16,0,20,0.2,0.8,0.0
A14971,10,11,0,21,0.48,0.52,0.0
A14972,4,10,3,17,0.24,0.59,0.18
A14973,2,2,5,9,0.22,0.22,0.56
A14974,10,23,0,33,0.3,0.7,0.0
A14975,2,6,0,8,0.25,0.75,0.0
A14976,13,1,9,23,0.57,0.04,0.39
A14977,24,10,1,35,0.69,0.29,0.03
A14978,0,5,0,5,0.0,1.0,0.0
A14979,3,6,0,9,0.33,0.67,0.0
A14980,6,30,1,37,0.16,0.81,0.03
A14981,1,2,0,3,0.33,0.67,0.0
A14983,0,5,0,5,0.0,1.0,0.0
A14984,10,22,0,32,0.31,0.69,0.0
A14985,2,1,0,3,0.67,0.33,0.0
A14986,0,5,0,5,0.0,1.0,0.0
A14987,0,3,0,3,0.0,1.0,0.0
A14988,5,8,0,13,0.38,0.62,0.0
A14989,11,15,0,26,0.42,0.58,0.0
A14990,1,5,0,6,0.17,0.83,0.0
A14991,17,15,11,43,0.4,0.35,0.26
A14993,3,2,0,5,0.6,0.4,0.0
A14994,0,2,0,2,0.0,1.0,0.0
A14995,85,41,2,128,0.66,0.32,0.02
A14996,7,8,0,15,0.47,0.53,0.0
A14997,1,2,0,3,0.33,0.67,0.0
A14998,4,2,0,6,0.67,0.33,0.0
A14999,21,14,0,35,0.6,0.4,0.0
A15000,8,12,0,20,0.4,0.6,0.0
A15001,4,14,1,19,0.21,0.74,0.05
A15002,7,3,11,21,0.33,0.14,0.52
A15003,13,9,0,22,0.59,0.41,0.0
A15004,8,3,1,12,0.67,0.25,0.08
A15005,17,6,2,25,0.68,0.24,0.08
A15007,8,6,9,23,0.35,0.26,0.39
A15008,58,29,1,88,0.66,0.33,0.01
A15009,10,7,2,19,0.53,0.37,0.11
A15010,1,3,0,4,0.25,0.75,0.0
A15011,5,5,1,11,0.45,0.45,0.09
A15012,15,6,4,25,0.6,0.24,0.16
A15013,0,2,0,2,0.0,1.0,0.0
A15015,5,13,0,18,0.28,0.72,0.0
A15016,0,3,0,3,0.0,1.0,0.0
A15017,1,2,0,3,0.33,0.67,0.0
A15018,2,5,0,7,0.29,0.71,0.0
A15019,8,8,0,16,0.5,0.5,0.0
A15020,0,0,1,1,0.0,0.0,1.0
A15021,0,2,0,2,0.0,1.0,0.0
A15022,2,2,0,4,0.5,0.5,0.0
A15023,1,0,0,1,1.0,0.0,0.0
A15025,31,41,5,77,0.4,0.53,0.06
A15026,12,7,3,22,0.55,0.32,0.14
A15027,35,26,0,61,0.57,0.43,0.0
A15028,9,11,2,22,0.41,0.5,0.09
A15029,6,9,0,15,0.4,0.6,0.0
A15030,1,2,0,3,0.33,0.67,0.0
A15031,0,1,0,1,0.0,1.0,0.0
A15032,0,2,0,2,0.0,1.0,0.0
A15033,1,3,0,4,0.25,0.75,0.0
A15034,4,7,0,11,0.36,0.64,0.0
A15035,0,0,1,1,0.0,0.0,1.0
A15038,1,0,0,1,1.0,0.0,0.0
A15039,1,3,0,4,0.25,0.75,0.0
A15040,1,0,0,1,1.0,0.0,0.0
A15041,1,1,0,2,0.5,0.5,0.0
A15042,0,1,0,1,0.0,1.0,0.0
A15043,1,0,0,1,1.0,0.0,0.0
A15044,1,0,0,1,1.0,0.0,0.0
A15045,2,4,0,6,0.33,0.67,0.0
A15046,7,6,1,14,0.5,0.43,0.07
A15047,13,4,5,22,0.59,0.18,0.23
A15048,2,1,0,3,0.67,0.33,0.0
A15049,2,12,0,14,0.14,0.86,0.0
A15050,6,7,0,13,0.46,0.54,0.0
A15051,0,1,0,1,0.0,1.0,0.0
A15052,39,21,0,60,0.65,0.35,0.0
A15053,17,15,0,32,0.53,0.47,0.0
A15054,21,25,0,46,0.46,0.54,0.0
A15057,16,17,1,34,0.47,0.5,0.03
A15058,0,2,0,2,0.0,1.0,0.0
A15059,6,7,0,13,0.46,0.54,0.0
A15060,2,1,4,7,0.29,0.14,0.57
A15061,0,1,0,1,0.0,1.0,0.0
A15063,13,34,0,47,0.28,0.72,0.0
A15064,2,2,0,4,0.5,0.5,0.0
A15065,4,4,0,8,0.5,0.5,0.0
A15066,23,20,1,44,0.52,0.45,0.02
A15067,0,1,0,1,0.0,1.0,0.0
A15069,0,5,0,5,0.0,1.0,0.0
A15070,1,3,0,4,0.25,0.75,0.0
A15071,0,1,0,1,0.0,1.0,0.0
A15072,4,3,0,7,0.57,0.43,0.0
A15073,11,2,0,13,0.85,0.15,0.0
A15074,11,15,4,30,0.37,0.5,0.13
A15075,1,7,0,8,0.12,0.88,0.0
A15076,17,9,0,26,0.65,0.35,0.0
A15077,4,4,2,10,0.4,0.4,0.2
A15078,10,25,0,35,0.29,0.71,0.0
A15079,326,366,22,714,0.46,0.51,0.03
A15080,6,13,1,20,0.3,0.65,0.05
A15081,2,2,1,5,0.4,0.4,0.2
A15082,4,2,0,6,0.67,0.33,0.0
A15083,17,21,2,40,0.42,0.53,0.05
A15084,4,3,0,7,0.57,0.43,0.0
A15086,5,12,0,17,0.29,0.71,0.0
A15087,3,4,2,9,0.33,0.44,0.22
A15088,2,5,0,7,0.29,0.71,0.0
A15089,45,68,1,114,0.39,0.6,0.01
A15090,9,5,2,16,0.56,0.31,0.12
A15091,11,12,0,23,0.48,0.52,0.0
A15092,4,5,7,16,0.25,0.31,0.44
A15093,19,27,1,47,0.4,0.57,0.02
A15094,0,1,1,2,0.0,0.5,0.5
A15095,14,12,3,29,0.48,0.41,0.1
A15096,2,1,0,3,0.67,0.33,0.0
A15097,1,2,0,3,0.33,0.67,0.0
A15098,9,4,1,14,0.64,0.29,0.07
A15099,4,7,1,12,0.33,0.58,0.08
A15100,5,5,1,11,0.45,0.45,0.09
A15101,13,3,6,22,0.59,0.14,0.27
A15102,25,17,1,43,0.58,0.4,0.02
A15103,23,34,0,57,0.4,0.6,0.0
A15104,0,1,0,1,0.0,1.0,0.0
A15105,2,2,0,4,0.5,0.5,0.0
A15106,4,11,0,15,0.27,0.73,0.0
A15108,15,8,0,23,0.65,0.35,0.0
A15109,0,3,0,3,0.0,1.0,0.0
A15110,1,2,0,3,0.33,0.67,0.0
A15111,27,10,0,37,0.73,0.27,0.0
A15112,24,47,0,71,0.34,0.66,0.0
A15113,5,3,0,8,0.62,0.38,0.0
A15114,2,5,0,7,0.29,0.71,0.0
A15115,45,26,5,76,0.59,0.34,0.07
A15116,29,27,0,56,0.52,0.48,0.0
A15117,0,2,0,2,0.0,1.0,0.0
A15118,6,7,3,16,0.38,0.44,0.19
A15119,10,11,0,21,0.48,0.52,0.0
A15121,2,3,0,5,0.4,0.6,0.0
A15122,0,1,0,1,0.0,1.0,0.0
A15123,5,4,0,9,0.56,0.44,0.0
A15124,1,3,0,4,0.25,0.75,0.0
A15125,2,9,0,11,0.18,0.82,0.0
A15126,3,9,0,12,0.25,0.75,0.0
A15127,5,7,0,12,0.42,0.58,0.0
A15128,0,1,0,1,0.0,1.0,0.0
A15129,1,9,0,10,0.1,0.9,0.0
A15130,7,24,0,31,0.23,0.77,0.0
A15131,2,0,2,4,0.5,0.0,0.5
A15132,7,4,0,11,0.64,0.36,0.0
A15133,343,271,57,671,0.51,0.4,0.08
A15134,4,9,0,13,0.31,0.69,0.0
A15136,13,3,12,28,0.46,0.11,0.43
A15137,3,1,0,4,0.75,0.25,0.0
A15138,0,4,0,4,0.0,1.0,0.0
A15139,18,21,1,40,0.45,0.53,0.03
A15140,8,9,0,17,0.47,0.53,0.0
A15141,2,7,0,9,0.22,0.78,0.0
A15142,8,5,0,13,0.62,0.38,0.0
A15143,24,24,0,48,0.5,0.5,0.0
A15144,11,13,0,24,0.46,0.54,0.0
A15145,9,4,0,13,0.69,0.31,0.0
A15146,5,9,0,14,0.36,0.64,0.0
A15147,4,6,0,10,0.4,0.6,0.0
A15148,29,8,15,52,0.56,0.15,0.29
A15149,6,4,0,10,0.6,0.4,0.0
A15150,18,9,0,27,0.67,0.33,0.0
A15151,5,10,0,15,0.33,0.67,0.0
A15152,6,6,0,12,0.5,0.5,0.0
A15153,7,11,0,18,0.39,0.61,0.0
A15154,8,7,0,15,0.53,0.47,0.0
A15155,63,17,9,89,0.71,0.19,0.1
A15156,11,13,0,24,0.46,0.54,0.0
A15157,11,13,0,24,0.46,0.54,0.0
A15158,1,6,0,7,0.14,0.86,0.0
A15159,0,2,0,2,0.0,1.0,0.0
A15160,0,2,0,2,0.0,1.0,0.0
A15161,2,5,0,7,0.29,0.71,0.0
A15162,30,58,0,88,0.34,0.66,0.0
A15163,2,8,0,10,0.2,0.8,0.0
A15164,3,13,0,16,0.19,0.81,0.0
A15165,5,1,0,6,0.83,0.17,0.0
A15166,20,40,0,60,0.33,0.67,0.0
A15167,14,7,0,21,0.67,0.33,0.0
A15168,27,4,0,31,0.87,0.13,0.0
A15171,16,8,1,25,0.64,0.32,0.04
A15172,0,1,0,1,0.0,1.0,0.0
A15173,18,19,0,37,0.49,0.51,0.0
A15175,6,13,0,19,0.32,0.68,0.0
A15176,2,8,0,10,0.2,0.8,0.0
A15177,1,5,1,7,0.14,0.71,0.14
A15178,38,61,0,99,0.38,0.62,0.0
A15180,2,3,0,5,0.4,0.6,0.0
A15181,12,23,0,35,0.34,0.66,0.0
A15182,3,2,0,5,0.6,0.4,0.0
A15183,0,3,0,3,0.0,1.0,0.0
A15184,11,20,1,32,0.34,0.62,0.03
A15185,12,5,0,17,0.71,0.29,0.0
A15186,0,7,1,8,0.0,0.88,0.12
A15187,233,62,8,303,0.77,0.2,0.03
A15188,28,14,2,44,0.64,0.32,0.05
A15189,10,11,0,21,0.48,0.52,0.0
A15190,3,4,0,7,0.43,0.57,0.0
A15191,6,3,0,9,0.67,0.33,0.0
A15193,55,20,6,81,0.68,0.25,0.07
A15194,4,14,0,18,0.22,0.78,0.0
A15195,5,6,0,11,0.45,0.55,0.0
A15196,13,10,2,25,0.52,0.4,0.08
A15197,2,6,0,8,0.25,0.75,0.0
A15198,6,2,1,9,0.67,0.22,0.11
A15199,0,4,0,4,0.0,1.0,0.0
A15200,24,13,0,37,0.65,0.35,0.0
A15201,0,2,0,2,0.0,1.0,0.0
A15203,19,13,0,32,0.59,0.41,0.0
A15204,1,1,0,2,0.5,0.5,0.0
A15205,5,6,0,11,0.45,0.55,0.0
A15206,2,3,2,7,0.29,0.43,0.29
A15207,5,20,0,25,0.2,0.8,0.0
A15209,6,3,0,9,0.67,0.33,0.0
A15210,4,4,1,9,0.44,0.44,0.11
A15211,5,8,0,13,0.38,0.62,0.0
A15212,1,5,0,6,0.17,0.83,0.0
A15213,0,3,0,3,0.0,1.0,0.0
A15215,8,7,0,15,0.53,0.47,0.0
A15216,27,31,0,58,0.47,0.53,0.0
A15218,2,5,0,7,0.29,0.71,0.0
A15219,0,6,0,6,0.0,1.0,0.0
A15220,19,9,0,28,0.68,0.32,0.0
A15222,23,23,0,46,0.5,0.5,0.0
A15223,11,15,0,26,0.42,0.58,0.0
A15224,1,2,0,3,0.33,0.67,0.0
A15225,19,13,1,33,0.58,0.39,0.03
A15226,9,10,0,19,0.47,0.53,0.0
A15227,1,6,0,7,0.14,0.86,0.0
A15228,11,15,0,26,0.42,0.58,0.0
A15231,2,2,0,4,0.5,0.5,0.0
A15232,3,7,0,10,0.3,0.7,0.0
A15233,1,3,0,4,0.25,0.75,0.0
A15234,1,0,0,1,1.0,0.0,0.0
A15235,5,17,0,22,0.23,0.77,0.0
A15236,28,42,0,70,0.4,0.6,0.0
A15237,3,3,0,6,0.5,0.5,0.0
A15238,1,1,0,2,0.5,0.5,0.0
A15240,0,14,0,14,0.0,1.0,0.0
A15241,0,3,0,3,0.0,1.0,0.0
A15242,5,6,0,11,0.45,0.55,0.0
A15243,24,7,0,31,0.77,0.23,0.0
A15244,6,16,0,22,0.27,0.73,0.0
A15245,1,3,0,4,0.25,0.75,0.0
A15250,4,6,0,10,0.4,0.6,0.0
A15251,0,5,0,5,0.0,1.0,0.0
A15252,7,3,0,10,0.7,0.3,0.0
A15253,1,6,2,9,0.11,0.67,0.22
A15254,13,36,0,49,0.27,0.73,0.0
A15255,0,5,1,6,0.0,0.83,0.17
A15256,0,3,0,3,0.0,1.0,0.0
A15257,26,12,0,38,0.68,0.32,0.0
A15258,0,1,0,1,0.0,1.0,0.0
A15259,1,3,1,5,0.2,0.6,0.2
A15260,4,7,0,11,0.36,0.64,0.0
A15261,27,65,1,93,0.29,0.7,0.01
A15262,3,9,2,14,0.21,0.64,0.14
A15263,0,2,0,2,0.0,1.0,0.0
A15264,0,1,0,1,0.0,1.0,0.0
A15265,1,0,0,1,1.0,0.0,0.0
A15266,1,2,0,3,0.33,0.67,0.0
A15267,3,5,0,8,0.38,0.62,0.0
A15268,0,2,0,2,0.0,1.0,0.0
A15269,6,12,0,18,0.33,0.67,0.0
A15271,3,0,3,6,0.5,0.0,0.5
A15272,2,14,0,16,0.12,0.88,0.0
A15273,6,6,1,13,0.46,0.46,0.08
A15275,56,97,0,153,0.37,0.63,0.0
A15276,4,20,1,25,0.16,0.8,0.04
A15279,5,25,1,31,0.16,0.81,0.03
A15280,10,6,1,17,0.59,0.35,0.06
A15281,1,2,3,6,0.17,0.33,0.5
A15282,5,7,0,12,0.42,0.58,0.0
A15283,0,2,0,2,0.0,1.0,0.0
A15284,0,2,0,2,0.0,1.0,0.0
A15285,0,1,0,1,0.0,1.0,0.0
A15286,0,7,0,7,0.0,1.0,0.0
A15287,1,4,0,5,0.2,0.8,0.0
A15288,26,56,2,84,0.31,0.67,0.02
A15289,3,6,0,9,0.33,0.67,0.0
A15290,1,2,0,3,0.33,0.67,0.0
A15291,0,1,0,1,0.0,1.0,0.0
A15292,0,1,0,1,0.0,1.0,0.0
A15293,1,12,0,13,0.08,0.92,0.0
A15294,1,6,0,7,0.14,0.86,0.0
A15295,0,2,1,3,0.0,0.67,0.33
A15296,3,4,0,7,0.43,0.57,0.0
A15297,2,3,0,5,0.4,0.6,0.0
A15299,7,3,0,10,0.7,0.3,0.0
A15300,26,49,0,75,0.35,0.65,0.0
A15302,3,7,0,10,0.3,0.7,0.0
A15303,0,1,0,1,0.0,1.0,0.0
A15304,30,15,0,45,0.67,0.33,0.0
A15305,1,4,0,5,0.2,0.8,0.0
A15306,9,7,0,16,0.56,0.44,0.0
A15307,22,9,0,31,0.71,0.29,0.0
A15308,0,1,0,1,0.0,1.0,0.0
A15309,5,6,0,11,0.45,0.55,0.0
A15310,2,5,0,7,0.29,0.71,0.0
A15311,0,2,0,2,0.0,1.0,0.0
A15312,1,1,0,2,0.5,0.5,0.0
A15315,8,10,0,18,0.44,0.56,0.0
A15316,0,2,0,2,0.0,1.0,0.0
A15317,4,8,0,12,0.33,0.67,0.0
A15318,2,4,0,6,0.33,0.67,0.0
A15320,0,2,0,2,0.0,1.0,0.0
A15322,1,1,1,3,0.33,0.33,0.33
A15327,18,26,0,44,0.41,0.59,0.0
A15328,1,1,0,2,0.5,0.5,0.0
A15329,0,3,0,3,0.0,1.0,0.0
A15330,14,11,0,25,0.56,0.44,0.0
A15331,3,5,0,8,0.38,0.62,0.0
A15332,1,4,0,5,0.2,0.8,0.0
A15333,0,0,1,1,0.0,0.0,1.0
A15335,1,5,0,6,0.17,0.83,0.0
A15336,0,3,0,3,0.0,1.0,0.0
A15337,14,23,2,39,0.36,0.59,0.05
A15338,2,0,0,2,1.0,0.0,0.0
A15339,0,1,0,1,0.0,1.0,0.0
A15340,11,18,0,29,0.38,0.62,0.0
A15341,9,15,0,24,0.38,0.62,0.0
A15342,59,16,17,92,0.64,0.17,0.18
A15343,2,5,0,7,0.29,0.71,0.0
A15345,2,2,0,4,0.5,0.5,0.0
A15346,1,0,0,1,1.0,0.0,0.0
A15347,6,3,0,9,0.67,0.33,0.0
A15348,9,8,0,17,0.53,0.47,0.0
A15349,5,2,0,7,0.71,0.29,0.0
A15352,0,1,0,1,0.0,1.0,0.0
A15353,2,9,0,11,0.18,0.82,0.0
A15354,1,1,0,2,0.5,0.5,0.0
A15356,0,0,1,1,0.0,0.0,1.0
A15358,2,2,0,4,0.5,0.5,0.0
A15359,8,12,1,21,0.38,0.57,0.05
A15360,9,13,0,22,0.41,0.59,0.0
A15361,3,8,1,12,0.25,0.67,0.08
A15362,2,0,0,2,1.0,0.0,0.0
A15363,2,3,0,5,0.4,0.6,0.0
A15367,3,8,0,11,0.27,0.73,0.0
A15370,5,2,0,7,0.71,0.29,0.0
A15371,2,9,0,11,0.18,0.82,0.0
A15373,13,10,0,23,0.57,0.43,0.0
A15376,6,15,0,21,0.29,0.71,0.0
A15377,3,0,1,4,0.75,0.0,0.25
A15378,3,7,0,10,0.3,0.7,0.0
A15379,3,3,0,6,0.5,0.5,0.0
A15380,9,3,0,12,0.75,0.25,0.0
A15383,19,22,1,42,0.45,0.52,0.02
A15386,12,6,0,18,0.67,0.33,0.0
A15387,1,3,0,4,0.25,0.75,0.0
A15388,1,4,0,5,0.2,0.8,0.0
A15389,24,10,0,34,0.71,0.29,0.0
A15390,3,1,0,4,0.75,0.25,0.0
A15391,0,0,1,1,0.0,0.0,1.0
A15392,1,2,0,3,0.33,0.67,0.0
A15393,0,1,0,1,0.0,1.0,0.0
A15394,2,1,0,3,0.67,0.33,0.0
A15395,4,4,0,8,0.5,0.5,0.0
A15396,0,1,0,1,0.0,1.0,0.0
A15397,44,40,0,84,0.52,0.48,0.0
A15398,22,27,0,49,0.45,0.55,0.0
A15399,4,4,0,8,0.5,0.5,0.0
A15400,0,1,0,1,0.0,1.0,0.0
A15401,7,5,3,15,0.47,0.33,0.2
A15402,0,1,0,1,0.0,1.0,0.0
A15403,3,4,0,7,0.43,0.57,0.0
A15404,12,6,0,18,0.67,0.33,0.0
A15405,2,5,1,8,0.25,0.62,0.12
A15409,1,0,1,2,0.5,0.0,0.5
A15410,11,9,0,20,0.55,0.45,0.0
A15411,15,15,2,32,0.47,0.47,0.06
A15412,1,2,0,3,0.33,0.67,0.0
A15413,6,5,0,11,0.55,0.45,0.0
A15414,6,7,1,14,0.43,0.5,0.07
A15415,15,11,2,28,0.54,0.39,0.07
A15416,1,1,0,2,0.5,0.5,0.0
A15417,0,2,0,2,0.0,1.0,0.0
A15418,4,14,0,18,0.22,0.78,0.0
A15419,1,4,0,5,0.2,0.8,0.0
A15420,25,4,1,30,0.83,0.13,0.03
A15421,6,6,0,12,0.5,0.5,0.0
A15422,7,1,17,25,0.28,0.04,0.68
A15423,1,1,0,2,0.5,0.5,0.0
A15424,5,4,12,21,0.24,0.19,0.57
A15425,3,3,0,6,0.5,0.5,0.0
A15426,0,1,0,1,0.0,1.0,0.0
A15427,0,1,0,1,0.0,1.0,0.0
A15428,1,9,0,10,0.1,0.9,0.0
A15429,34,19,1,54,0.63,0.35,0.02
A15430,1,2,0,3,0.33,0.67,0.0
A15431,1,1,0,2,0.5,0.5,0.0
A15432,0,2,0,2,0.0,1.0,0.0
A15433,42,27,21,90,0.47,0.3,0.23
A15435,53,15,6,74,0.72,0.2,0.08
A15436,5,2,2,9,0.56,0.22,0.22
A15437,11,7,1,19,0.58,0.37,0.05
A15438,3,1,0,4,0.75,0.25,0.0
A15439,54,21,2,77,0.7,0.27,0.03
A15440,6,10,1,17,0.35,0.59,0.06
A15441,23,7,0,30,0.77,0.23,0.0
A15443,3,6,0,9,0.33,0.67,0.0
A15444,14,10,0,24,0.58,0.42,0.0
A15445,0,3,0,3,0.0,1.0,0.0
A15446,2,12,0,14,0.14,0.86,0.0
A15448,0,1,0,1,0.0,1.0,0.0
A15449,0,1,0,1,0.0,1.0,0.0
A15450,4,5,6,15,0.27,0.33,0.4
A15451,11,7,2,20,0.55,0.35,0.1
A15452,4,4,0,8,0.5,0.5,0.0
A15453,21,9,0,30,0.7,0.3,0.0
A15454,0,3,0,3,0.0,1.0,0.0
A15455,2,0,0,2,1.0,0.0,0.0
A15457,2,0,0,2,1.0,0.0,0.0
A15458,37,8,0,45,0.82,0.18,0.0
A15459,5,12,0,17,0.29,0.71,0.0
A15460,0,1,0,1,0.0,1.0,0.0
A15461,0,1,0,1,0.0,1.0,0.0
A15462,5,16,0,21,0.24,0.76,0.0
A15463,5,6,0,11,0.45,0.55,0.0
A15464,9,16,0,25,0.36,0.64,0.0
A15465,1,3,0,4,0.25,0.75,0.0
A15466,9,4,2,15,0.6,0.27,0.13
A15467,4,2,0,6,0.67,0.33,0.0
A15468,2,4,5,11,0.18,0.36,0.45
A15469,2,10,1,13,0.15,0.77,0.08
A15470,6,11,0,17,0.35,0.65,0.0
A15471,0,3,0,3,0.0,1.0,0.0
A15472,14,5,0,19,0.74,0.26,0.0
A15473,0,7,0,7,0.0,1.0,0.0
A15474,4,14,0,18,0.22,0.78,0.0
A15475,3,2,0,5,0.6,0.4,0.0
A15476,5,8,0,13,0.38,0.62,0.0
A15478,1,6,0,7,0.14,0.86,0.0
A15479,6,6,0,12,0.5,0.5,0.0
A15480,20,78,1,99,0.2,0.79,0.01
A15481,5,9,0,14,0.36,0.64,0.0
A15482,34,31,0,65,0.52,0.48,0.0
A15483,11,17,0,28,0.39,0.61,0.0
A15484,9,7,0,16,0.56,0.44,0.0
A15485,2,45,0,47,0.04,0.96,0.0
A15486,7,8,0,15,0.47,0.53,0.0
A15487,4,2,1,7,0.57,0.29,0.14
A15488,96,141,1,238,0.4,0.59,0.0
A15489,0,4,0,4,0.0,1.0,0.0
A15490,3,20,0,23,0.13,0.87,0.0
A15491,14,15,1,30,0.47,0.5,0.03
A15492,24,22,2,48,0.5,0.46,0.04
A15493,0,3,0,3,0.0,1.0,0.0
A15494,4,2,0,6,0.67,0.33,0.0
A15495,212,60,1,273,0.78,0.22,0.0
A15496,0,2,0,2,0.0,1.0,0.0
A15497,101,36,0,137,0.74,0.26,0.0
A15498,0,1,0,1,0.0,1.0,0.0
A15499,11,7,0,18,0.61,0.39,0.0
A15501,7,1,0,8,0.88,0.12,0.0
A15502,185,13,2,200,0.93,0.07,0.01
A15503,5,8,0,13,0.38,0.62,0.0
A15504,1,0,0,1,1.0,0.0,0.0
A15505,3,14,0,17,0.18,0.82,0.0
A15506,15,4,0,19,0.79,0.21,0.0
A15507,4,2,0,6,0.67,0.33,0.0
A15508,17,14,0,31,0.55,0.45,0.0
A15509,15,24,0,39,0.38,0.62,0.0
A15510,7,14,0,21,0.33,0.67,0.0
A15511,6,10,0,16,0.38,0.62,0.0
A15512,2,3,0,5,0.4,0.6,0.0
A15513,94,30,0,124,0.76,0.24,0.0
A15514,9,8,2,19,0.47,0.42,0.11
A15515,0,1,0,1,0.0,1.0,0.0
A15516,51,30,0,81,0.63,0.37,0.0
A15517,9,1,1,11,0.82,0.09,0.09
A15518,3,3,1,7,0.43,0.43,0.14
A15519,1,4,0,5,0.2,0.8,0.0
A15520,0,2,0,2,0.0,1.0,0.0
A15521,0,1,0,1,0.0,1.0,0.0
A15522,5,1,0,6,0.83,0.17,0.0
A15523,0,1,0,1,0.0,1.0,0.0
A15524,8,3,0,11,0.73,0.27,0.0
A15526,9,8,0,17,0.53,0.47,0.0
A15527,4,3,0,7,0.57,0.43,0.0
A15529,4,4,0,8,0.5,0.5,0.0
A15530,3,1,0,4,0.75,0.25,0.0
A15531,0,2,0,2,0.0,1.0,0.0
A15532,137,10,0,147,0.93,0.07,0.0
A15533,5,7,0,12,0.42,0.58,0.0
A15534,18,15,0,33,0.55,0.45,0.0
A15535,1,1,0,2,0.5,0.5,0.0
A15536,4,5,0,9,0.44,0.56,0.0
A15537,0,3,0,3,0.0,1.0,0.0
A15539,2,12,0,14,0.14,0.86,0.0
A15540,5,4,0,9,0.56,0.44,0.0
A15541,1,0,0,1,1.0,0.0,0.0
A15542,0,2,0,2,0.0,1.0,0.0
A15547,16,65,1,82,0.2,0.79,0.01
A15549,0,7,0,7,0.0,1.0,0.0
A15550,9,5,0,14,0.64,0.36,0.0
A15552,15,10,0,25,0.6,0.4,0.0
A15554,3,1,0,4,0.75,0.25,0.0
A15555,128,140,0,268,0.48,0.52,0.0
A15556,7,8,0,15,0.47,0.53,0.0
A15557,25,23,0,48,0.52,0.48,0.0
A15558,33,29,0,62,0.53,0.47,0.0
A15559,31,53,1,85,0.36,0.62,0.01
A15560,1,9,0,10,0.1,0.9,0.0
A15562,13,12,0,25,0.52,0.48,0.0
A15563,2,6,0,8,0.25,0.75,0.0
A15564,2,0,0,2,1.0,0.0,0.0
A15565,1,2,0,3,0.33,0.67,0.0
A15566,9,7,0,16,0.56,0.44,0.0
A15568,10,23,1,34,0.29,0.68,0.03
A15569,1,3,0,4,0.25,0.75,0.0
A15570,1,3,0,4,0.25,0.75,0.0
A15571,3,7,0,10,0.3,0.7,0.0
A15572,0,6,0,6,0.0,1.0,0.0
A15573,1,0,1,2,0.5,0.0,0.5
A15574,3,0,0,3,1.0,0.0,0.0
A15575,10,22,1,33,0.3,0.67,0.03
A15576,0,1,0,1,0.0,1.0,0.0
A15577,2,6,0,8,0.25,0.75,0.0
A15578,1,0,0,1,1.0,0.0,0.0
A15582,0,1,0,1,0.0,1.0,0.0
A15583,1,0,0,1,1.0,0.0,0.0
A15587,2,2,1,5,0.4,0.4,0.2
A15588,0,1,0,1,0.0,1.0,0.0
A15590,1,1,1,3,0.33,0.33,0.33
A15591,1,13,0,14,0.07,0.93,0.0
A15592,2,5,0,7,0.29,0.71,0.0
A15595,7,2,0,9,0.78,0.22,0.0
A15596,18,13,0,31,0.58,0.42,0.0
A15598,0,1,0,1,0.0,1.0,0.0
A15599,2,1,0,3,0.67,0.33,0.0
A15601,29,21,0,50,0.58,0.42,0.0
A15602,3,2,0,5,0.6,0.4,0.0
A15603,5,1,3,9,0.56,0.11,0.33
A15604,29,19,0,48,0.6,0.4,0.0
A15605,14,8,0,22,0.64,0.36,0.0
A15608,0,1,0,1,0.0,1.0,0.0
A15610,12,4,0,16,0.75,0.25,0.0
A15611,7,8,0,15,0.47,0.53,0.0
A15613,8,10,1,19,0.42,0.53,0.05
A15615,4,7,0,11,0.36,0.64,0.0
A15617,1,0,0,1,1.0,0.0,0.0
A15618,2,8,0,10,0.2,0.8,0.0
A15619,1,0,0,1,1.0,0.0,0.0
A15622,0,1,0,1,0.0,1.0,0.0
A15623,10,12,0,22,0.45,0.55,0.0
A15624,6,4,0,10,0.6,0.4,0.0
A15626,34,12,0,46,0.74,0.26,0.0
A15628,1,1,0,2,0.5,0.5,0.0
A15629,2,5,0,7,0.29,0.71,0.0
A15630,6,9,0,15,0.4,0.6,0.0
A15631,0,3,0,3,0.0,1.0,0.0
A15632,69,19,0,88,0.78,0.22,0.0
A15635,1,3,0,4,0.25,0.75,0.0
A15636,4,6,0,10,0.4,0.6,0.0
A15638,4,5,0,9,0.44,0.56,0.0
A15639,12,10,0,22,0.55,0.45,0.0
A15640,53,19,0,72,0.74,0.26,0.0
A15641,10,9,0,19,0.53,0.47,0.0
A15645,22,3,0,25,0.88,0.12,0.0
A15646,12,21,0,33,0.36,0.64,0.0
A15654,0,4,0,4,0.0,1.0,0.0
A15655,1,5,0,6,0.17,0.83,0.0
A15656,6,15,0,21,0.29,0.71,0.0
A15657,0,1,0,1,0.0,1.0,0.0
A15659,0,4,0,4,0.0,1.0,0.0
A15660,2,1,0,3,0.67,0.33,0.0
A15661,26,23,0,49,0.53,0.47,0.0
A15662,0,8,0,8,0.0,1.0,0.0
A15663,8,14,1,23,0.35,0.61,0.04
A15665,7,4,0,11,0.64,0.36,0.0
A15666,9,3,0,12,0.75,0.25,0.0
A15667,7,8,0,15,0.47,0.53,0.0
A15668,1,1,0,2,0.5,0.5,0.0
A15669,19,23,0,42,0.45,0.55,0.0
A15670,3,2,0,5,0.6,0.4,0.0
A15671,13,10,0,23,0.57,0.43,0.0
A15672,2,5,0,7,0.29,0.71,0.0
A15673,17,23,1,41,0.41,0.56,0.02
A15674,1,3,0,4,0.25,0.75,0.0
A15675,0,3,0,3,0.0,1.0,0.0
A15676,10,14,0,24,0.42,0.58,0.0
A15677,4,1,0,5,0.8,0.2,0.0
A15678,0,4,0,4,0.0,1.0,0.0
A15680,11,8,0,19,0.58,0.42,0.0
A15681,29,19,0,48,0.6,0.4,0.0
A15682,0,1,0,1,0.0,1.0,0.0
A15686,4,3,0,7,0.57,0.43,0.0
A15687,0,2,0,2,0.0,1.0,0.0
A15688,3,1,0,4,0.75,0.25,0.0
A15689,2,0,0,2,1.0,0.0,0.0
A15690,2,9,0,11,0.18,0.82,0.0
A15691,23,29,0,52,0.44,0.56,0.0
A15693,0,1,0,1,0.0,1.0,0.0
A15695,5,15,0,20,0.25,0.75,0.0
A15696,0,5,0,5,0.0,1.0,0.0
A15697,0,1,0,1,0.0,1.0,0.0
A15698,62,60,0,122,0.51,0.49,0.0
A15699,4,11,0,15,0.27,0.73,0.0
A15700,7,7,0,14,0.5,0.5,0.0
A15701,2,1,0,3,0.67,0.33,0.0
A15702,0,7,0,7,0.0,1.0,0.0
A15703,3,3,0,6,0.5,0.5,0.0
A15704,9,12,0,21,0.43,0.57,0.0
A15705,18,22,7,47,0.38,0.47,0.15
A15706,11,9,0,20,0.55,0.45,0.0
A15708,2,1,0,3,0.67,0.33,0.0
A15709,32,14,0,46,0.7,0.3,0.0
A15710,10,12,0,22,0.45,0.55,0.0
A15711,5,10,0,15,0.33,0.67,0.0
A15712,38,18,0,56,0.68,0.32,0.0
A15713,68,26,1,95,0.72,0.27,0.01
A15714,28,8,8,44,0.64,0.18,0.18
A15715,0,3,0,3,0.0,1.0,0.0
A15716,13,21,0,34,0.38,0.62,0.0
A15717,28,14,0,42,0.67,0.33,0.0
A15718,7,10,0,17,0.41,0.59,0.0
A15719,7,10,0,17,0.41,0.59,0.0
A15720,9,9,0,18,0.5,0.5,0.0
A15721,15,14,1,30,0.5,0.47,0.03
A15722,28,3,0,31,0.9,0.1,0.0
A15723,3,6,0,9,0.33,0.67,0.0
A15724,1,4,0,5,0.2,0.8,0.0
A15725,10,7,0,17,0.59,0.41,0.0
A15726,6,5,0,11,0.55,0.45,0.0
A15727,1,1,0,2,0.5,0.5,0.0
A15729,7,9,0,16,0.44,0.56,0.0
A15730,2,2,0,4,0.5,0.5,0.0
A15731,1,1,0,2,0.5,0.5,0.0
A15732,3,1,0,4,0.75,0.25,0.0
A15733,14,28,0,42,0.33,0.67,0.0
A15734,54,31,0,85,0.64,0.36,0.0
A15735,1,7,0,8,0.12,0.88,0.0
A15736,3,4,0,7,0.43,0.57,0.0
A15737,12,16,0,28,0.43,0.57,0.0
A15738,3,5,0,8,0.38,0.62,0.0
A15739,18,22,1,41,0.44,0.54,0.02
A15740,0,0,1,1,0.0,0.0,1.0
A15741,5,9,0,14,0.36,0.64,0.0
A15743,0,2,0,2,0.0,1.0,0.0
A15744,1,5,0,6,0.17,0.83,0.0
A15751,14,27,3,44,0.32,0.61,0.07
A15753,11,9,1,21,0.52,0.43,0.05
A15754,16,15,0,31,0.52,0.48,0.0
A15756,0,1,1,2,0.0,0.5,0.5
A15758,6,4,0,10,0.6,0.4,0.0
A15759,2,8,0,10,0.2,0.8,0.0
A15761,0,2,0,2,0.0,1.0,0.0
A15762,6,5,0,11,0.55,0.45,0.0
A15764,1,3,0,4,0.25,0.75,0.0
A15767,2,3,0,5,0.4,0.6,0.0
A15768,2,3,0,5,0.4,0.6,0.0
A15769,1,1,0,2,0.5,0.5,0.0
A15770,0,1,0,1,0.0,1.0,0.0
A15771,0,1,0,1,0.0,1.0,0.0
A15772,1,1,0,2,0.5,0.5,0.0
A15773,17,10,0,27,0.63,0.37,0.0
A15774,5,6,0,11,0.45,0.55,0.0
A15775,10,8,0,18,0.56,0.44,0.0
A15776,10,10,1,21,0.48,0.48,0.05
A15777,1,0,1,2,0.5,0.0,0.5
A15778,79,140,0,219,0.36,0.64,0.0
A15780,5,9,0,14,0.36,0.64,0.0
A15781,1,5,0,6,0.17,0.83,0.0
A15782,6,5,0,11,0.55,0.45,0.0
A15783,45,23,0,68,0.66,0.34,0.0
A15784,0,4,0,4,0.0,1.0,0.0
A15785,1,1,0,2,0.5,0.5,0.0
A15786,2,1,0,3,0.67,0.33,0.0
A15787,2,1,0,3,0.67,0.33,0.0
A15788,7,11,0,18,0.39,0.61,0.0
A15789,0,4,0,4,0.0,1.0,0.0
A15790,12,12,0,24,0.5,0.5,0.0
A15791,81,162,4,247,0.33,0.66,0.02
A15792,12,8,0,20,0.6,0.4,0.0
A15793,7,5,0,12,0.58,0.42,0.0
A15794,0,1,0,1,0.0,1.0,0.0
A15795,21,22,0,43,0.49,0.51,0.0
A15796,44,11,1,56,0.79,0.2,0.02
A15797,90,32,3,125,0.72,0.26,0.02
A15798,9,3,0,12,0.75,0.25,0.0
A15799,5,5,0,10,0.5,0.5,0.0
A15800,0,1,0,1,0.0,1.0,0.0
A15801,4,14,0,18,0.22,0.78,0.0
A15802,3,6,0,9,0.33,0.67,0.0
A15803,0,2,0,2,0.0,1.0,0.0
A15805,13,16,1,30,0.43,0.53,0.03
A15806,87,19,1,107,0.81,0.18,0.01
A15809,17,18,0,35,0.49,0.51,0.0
A15810,0,1,0,1,0.0,1.0,0.0
A15811,2,1,1,4,0.5,0.25,0.25
A15813,0,1,0,1,0.0,1.0,0.0
A15814,30,13,0,43,0.7,0.3,0.0
A15815,14,8,1,23,0.61,0.35,0.04
A15816,24,23,2,49,0.49,0.47,0.04
A15817,1,0,0,1,1.0,0.0,0.0
A15818,74,35,0,109,0.68,0.32,0.0
A15819,36,14,0,50,0.72,0.28,0.0
A15820,26,12,0,38,0.68,0.32,0.0
A15821,6,3,0,9,0.67,0.33,0.0
A15822,0,11,0,11,0.0,1.0,0.0
A15823,5,8,0,13,0.38,0.62,0.0
A15824,2,8,0,10,0.2,0.8,0.0
A15826,0,3,0,3,0.0,1.0,0.0
A15827,2,4,0,6,0.33,0.67,0.0
A15829,15,11,0,26,0.58,0.42,0.0
A15830,16,29,23,68,0.24,0.43,0.34
A15831,6,3,0,9,0.67,0.33,0.0
A15832,1,1,0,2,0.5,0.5,0.0
A15834,0,2,0,2,0.0,1.0,0.0
A15836,0,1,0,1,0.0,1.0,0.0
A15838,1,3,0,4,0.25,0.75,0.0
A15839,3,1,5,9,0.33,0.11,0.56
A15840,7,11,0,18,0.39,0.61,0.0
A15841,6,1,3,10,0.6,0.1,0.3
A15842,1,3,0,4,0.25,0.75,0.0
A15843,4,1,11,16,0.25,0.06,0.69
A15846,12,4,0,16,0.75,0.25,0.0
A15847,9,4,0,13,0.69,0.31,0.0
A15848,9,4,1,14,0.64,0.29,0.07
A15849,2,2,0,4,0.5,0.5,0.0
A15850,9,21,0,30,0.3,0.7,0.0
A15851,1,6,0,7,0.14,0.86,0.0
A15852,0,1,0,1,0.0,1.0,0.0
A15853,2,9,0,11,0.18,0.82,0.0
A15854,4,7,0,11,0.36,0.64,0.0
A15855,2,1,0,3,0.67,0.33,0.0
A15857,0,3,0,3,0.0,1.0,0.0
A15858,14,7,0,21,0.67,0.33,0.0
A15859,4,7,0,11,0.36,0.64,0.0
A15860,1,0,2,3,0.33,0.0,0.67
A15861,4,4,0,8,0.5,0.5,0.0
A15863,0,1,0,1,0.0,1.0,0.0
A15864,0,1,0,1,0.0,1.0,0.0
A15865,0,2,0,2,0.0,1.0,0.0
A15866,8,22,0,30,0.27,0.73,0.0
A15868,3,3,0,6,0.5,0.5,0.0
A15869,4,8,0,12,0.33,0.67,0.0
A15870,9,9,0,18,0.5,0.5,0.0
A15872,2,7,0,9,0.22,0.78,0.0
A15874,0,5,0,5,0.0,1.0,0.0
A15875,1,9,0,10,0.1,0.9,0.0
A15876,1,0,0,1,1.0,0.0,0.0
A15877,30,12,0,42,0.71,0.29,0.0
A15878,2,2,0,4,0.5,0.5,0.0
A15879,16,11,0,27,0.59,0.41,0.0
A15880,63,10,0,73,0.86,0.14,0.0
A15881,8,16,0,24,0.33,0.67,0.0
A15883,6,5,0,11,0.55,0.45,0.0
A15884,3,19,0,22,0.14,0.86,0.0
A15885,3,1,0,4,0.75,0.25,0.0
A15887,1,3,0,4,0.25,0.75,0.0
A15888,21,12,0,33,0.64,0.36,0.0
A15890,15,17,0,32,0.47,0.53,0.0
A15891,11,13,0,24,0.46,0.54,0.0
A15892,7,4,0,11,0.64,0.36,0.0
A15893,1,2,0,3,0.33,0.67,0.0
A15894,8,8,1,17,0.47,0.47,0.06
A15895,1,1,0,2,0.5,0.5,0.0
A15898,2,3,0,5,0.4,0.6,0.0
A15899,10,25,0,35,0.29,0.71,0.0
A15900,280,517,1,798,0.35,0.65,0.0
A15901,1,3,0,4,0.25,0.75,0.0
A15902,16,28,0,44,0.36,0.64,0.0
A15903,2,0,0,2,1.0,0.0,0.0
A15904,4,14,0,18,0.22,0.78,0.0
A15905,10,19,0,29,0.34,0.66,0.0
A15906,8,32,0,40,0.2,0.8,0.0
A15908,4,4,1,9,0.44,0.44,0.11
A15909,4,16,0,20,0.2,0.8,0.0
A15910,2,1,0,3,0.67,0.33,0.0
A15911,12,13,0,25,0.48,0.52,0.0
A15912,21,11,0,32,0.66,0.34,0.0
A15913,2,7,0,9,0.22,0.78,0.0
A15914,3,9,0,12,0.25,0.75,0.0
A15915,203,38,3,244,0.83,0.16,0.01
A15916,58,15,0,73,0.79,0.21,0.0
A15917,20,14,0,34,0.59,0.41,0.0
A15918,4,4,0,8,0.5,0.5,0.0
A15919,19,15,1,35,0.54,0.43,0.03
A15920,2,0,5,7,0.29,0.0,0.71
A15921,1,4,1,6,0.17,0.67,0.17
A15924,0,2,0,2,0.0,1.0,0.0
A15925,1,1,0,2,0.5,0.5,0.0
A15926,6,20,0,26,0.23,0.77,0.0
A15927,5,4,0,9,0.56,0.44,0.0
A15931,0,2,0,2,0.0,1.0,0.0
A15932,9,1,1,11,0.82,0.09,0.09
A15933,8,3,0,11,0.73,0.27,0.0
A15934,48,88,1,137,0.35,0.64,0.01
A15935,3,4,0,7,0.43,0.57,0.0
A15936,14,22,0,36,0.39,0.61,0.0
A15937,1,1,0,2,0.5,0.5,0.0
A15939,0,1,0,1,0.0,1.0,0.0
A15940,0,2,0,2,0.0,1.0,0.0
A15942,46,93,0,139,0.33,0.67,0.0
A15943,4,4,1,9,0.44,0.44,0.11
A15944,3,1,0,4,0.75,0.25,0.0
A15945,2,3,0,5,0.4,0.6,0.0
A15946,3,2,0,5,0.6,0.4,0.0
A15947,2,10,0,12,0.17,0.83,0.0
A15948,0,1,0,1,0.0,1.0,0.0
A15949,2,2,0,4,0.5,0.5,0.0
A15952,1,2,0,3,0.33,0.67,0.0
A15953,10,33,0,43,0.23,0.77,0.0
A15955,2,0,0,2,1.0,0.0,0.0
A15956,10,7,0,17,0.59,0.41,0.0
A15957,6,8,0,14,0.43,0.57,0.0
A15958,13,11,0,24,0.54,0.46,0.0
A15959,2,2,0,4,0.5,0.5,0.0
A15960,30,36,0,66,0.45,0.55,0.0
A15961,19,5,0,24,0.79,0.21,0.0
A15962,9,3,0,12,0.75,0.25,0.0
A15963,2,5,0,7,0.29,0.71,0.0
A15966,1,2,0,3,0.33,0.67,0.0
A15968,1,1,0,2,0.5,0.5,0.0
A15969,3,7,0,10,0.3,0.7,0.0
A15970,22,35,0,57,0.39,0.61,0.0
A15971,2,9,0,11,0.18,0.82,0.0
A15972,1,2,0,3,0.33,0.67,0.0
A15974,20,9,0,29,0.69,0.31,0.0
A15976,0,0,2,2,0.0,0.0,1.0
A15977,1,0,0,1,1.0,0.0,0.0
A15978,2,0,0,2,1.0,0.0,0.0
A15981,2,0,0,2,1.0,0.0,0.0
A15982,2,0,0,2,1.0,0.0,0.0
A15983,51,48,0,99,0.52,0.48,0.0
A15984,0,1,0,1,0.0,1.0,0.0
A15986,5,6,0,11,0.45,0.55,0.0
A15987,1,1,0,2,0.5,0.5,0.0
A15988,2,1,0,3,0.67,0.33,0.0
A15989,0,6,0,6,0.0,1.0,0.0
A15990,1,1,0,2,0.5,0.5,0.0
A15991,2,0,0,2,1.0,0.0,0.0
A15993,0,3,0,3,0.0,1.0,0.0
A15994,0,1,0,1,0.0,1.0,0.0
A15995,1,0,0,1,1.0,0.0,0.0
A15998,96,119,1,216,0.44,0.55,0.0
A15999,10,12,3,25,0.4,0.48,0.12
A16000,5,4,6,15,0.33,0.27,0.4
A16004,9,14,0,23,0.39,0.61,0.0
A16005,1,0,0,1,1.0,0.0,0.0
A16006,1,1,0,2,0.5,0.5,0.0
A16007,32,26,0,58,0.55,0.45,0.0
A16008,0,1,0,1,0.0,1.0,0.0
A16009,1,2,0,3,0.33,0.67,0.0
A16010,10,14,1,25,0.4,0.56,0.04
A16011,1,1,0,2,0.5,0.5,0.0
A16013,0,2,0,2,0.0,1.0,0.0
A16014,2,4,0,6,0.33,0.67,0.0
A16015,11,15,0,26,0.42,0.58,0.0
A16016,2,5,0,7,0.29,0.71,0.0
A16017,4,6,0,10,0.4,0.6,0.0
A16018,3,4,2,9,0.33,0.44,0.22
A16019,1,1,0,2,0.5,0.5,0.0
A16020,0,1,0,1,0.0,1.0,0.0
A16024,4,3,0,7,0.57,0.43,0.0
A16025,2,0,0,2,1.0,0.0,0.0
A16026,1,1,0,2,0.5,0.5,0.0
A16028,5,5,0,10,0.5,0.5,0.0
A16029,11,7,0,18,0.61,0.39,0.0
A16030,2,0,0,2,1.0,0.0,0.0
A16031,1,3,0,4,0.25,0.75,0.0
A16033,26,24,1,51,0.51,0.47,0.02
A16034,2,2,0,4,0.5,0.5,0.0
A16036,0,3,0,3,0.0,1.0,0.0
A16039,3,3,0,6,0.5,0.5,0.0
A16040,16,10,3,29,0.55,0.34,0.1
A16042,0,2,0,2,0.0,1.0,0.0
A16043,2,3,0,5,0.4,0.6,0.0
A16045,16,129,1,146,0.11,0.88,0.01
A16046,2,2,2,6,0.33,0.33,0.33
A16047,6,19,0,25,0.24,0.76,0.0
A16048,10,18,0,28,0.36,0.64,0.0
A16049,0,1,0,1,0.0,1.0,0.0
A16050,5,2,0,7,0.71,0.29,0.0
A16052,1,9,0,10,0.1,0.9,0.0
A16053,2,7,0,9,0.22,0.78,0.0
A16054,1,3,0,4,0.25,0.75,0.0
A16055,4,4,0,8,0.5,0.5,0.0
A16056,2,0,0,2,1.0,0.0,0.0
A16057,10,8,0,18,0.56,0.44,0.0
A16058,8,7,0,15,0.53,0.47,0.0
A16059,2,0,0,2,1.0,0.0,0.0
A16060,14,27,0,41,0.34,0.66,0.0
A16061,11,12,0,23,0.48,0.52,0.0
A16062,3,6,0,9,0.33,0.67,0.0
A16064,5,5,0,10,0.5,0.5,0.0
A16065,4,5,0,9,0.44,0.56,0.0
A16066,9,18,0,27,0.33,0.67,0.0
A16067,4,10,0,14,0.29,0.71,0.0
A16068,1,0,0,1,1.0,0.0,0.0
A16069,0,2,0,2,0.0,1.0,0.0
A16071,20,4,3,27,0.74,0.15,0.11
A16072,0,2,0,2,0.0,1.0,0.0
A16074,1,4,1,6,0.17,0.67,0.17
A16078,14,5,0,19,0.74,0.26,0.0
A16079,1,9,1,11,0.09,0.82,0.09
A16080,13,17,2,32,0.41,0.53,0.06
A16081,1,5,0,6,0.17,0.83,0.0
A16082,4,10,0,14,0.29,0.71,0.0
A16083,1,1,0,2,0.5,0.5,0.0
A16084,0,7,0,7,0.0,1.0,0.0
A16085,1,1,0,2,0.5,0.5,0.0
A16086,25,56,0,81,0.31,0.69,0.0
A16087,1,7,1,9,0.11,0.78,0.11
A16088,1,3,0,4,0.25,0.75,0.0
A16091,2,7,0,9,0.22,0.78,0.0
A16092,4,4,4,12,0.33,0.33,0.33
A16093,8,5,0,13,0.62,0.38,0.0
A16094,1,0,0,1,1.0,0.0,0.0
A16096,5,10,0,15,0.33,0.67,0.0
A16098,0,6,0,6,0.0,1.0,0.0
A16099,18,55,0,73,0.25,0.75,0.0
A16102,5,19,0,24,0.21,0.79,0.0
A16103,0,1,0,1,0.0,1.0,0.0
A16104,2,2,0,4,0.5,0.5,0.0
A16105,6,2,0,8,0.75,0.25,0.0
A16106,1,6,0,7,0.14,0.86,0.0
A16107,164,202,3,369,0.44,0.55,0.01
A16108,33,85,0,118,0.28,0.72,0.0
A16109,1,2,0,3,0.33,0.67,0.0
A16110,11,6,24,41,0.27,0.15,0.59
A16111,8,6,1,15,0.53,0.4,0.07
A16112,4,1,1,6,0.67,0.17,0.17
A16113,1,1,0,2,0.5,0.5,0.0
A16114,1,3,0,4,0.25,0.75,0.0
A16115,26,383,3,412,0.06,0.93,0.01
A16116,5,37,0,42,0.12,0.88,0.0
A16117,1,2,0,3,0.33,0.67,0.0
A16118,0,3,0,3,0.0,1.0,0.0
A16119,2,10,0,12,0.17,0.83,0.0
A16120,94,133,1,228,0.41,0.58,0.0
A16121,35,26,0,61,0.57,0.43,0.0
A16122,4,1,0,5,0.8,0.2,0.0
A16123,20,19,0,39,0.51,0.49,0.0
A16124,18,7,0,25,0.72,0.28,0.0
A16125,0,0,3,3,0.0,0.0,1.0
A16126,7,9,0,16,0.44,0.56,0.0
A16127,3,12,0,15,0.2,0.8,0.0
A16128,0,3,0,3,0.0,1.0,0.0
A16129,0,5,0,5,0.0,1.0,0.0
A16130,1,0,0,1,1.0,0.0,0.0
A16131,6,1,0,7,0.86,0.14,0.0
A16132,16,25,0,41,0.39,0.61,0.0
A16133,0,7,0,7,0.0,1.0,0.0
A16134,4,5,0,9,0.44,0.56,0.0
A16135,2,4,0,6,0.33,0.67,0.0
A16136,7,27,0,34,0.21,0.79,0.0
A16137,7,26,0,33,0.21,0.79,0.0
A16139,1,3,0,4,0.25,0.75,0.0
A16141,20,8,0,28,0.71,0.29,0.0
A16142,41,51,1,93,0.44,0.55,0.01
A16143,7,9,0,16,0.44,0.56,0.0
A16144,10,3,0,13,0.77,0.23,0.0
A16145,3,5,0,8,0.38,0.62,0.0
A16146,1,2,0,3,0.33,0.67,0.0
A16148,1,0,0,1,1.0,0.0,0.0
A16149,13,13,0,26,0.5,0.5,0.0
A16150,2,6,0,8,0.25,0.75,0.0
A16151,35,14,0,49,0.71,0.29,0.0
A16152,10,19,0,29,0.34,0.66,0.0
A16153,9,11,0,20,0.45,0.55,0.0
A16154,4,21,0,25,0.16,0.84,0.0
A16155,1,4,0,5,0.2,0.8,0.0
A16156,50,21,0,71,0.7,0.3,0.0
A16157,23,44,0,67,0.34,0.66,0.0
A16158,7,6,0,13,0.54,0.46,0.0
A16159,4,9,0,13,0.31,0.69,0.0
A16160,8,3,0,11,0.73,0.27,0.0
A16161,4,8,0,12,0.33,0.67,0.0
A16164,0,2,0,2,0.0,1.0,0.0
A16166,1,2,0,3,0.33,0.67,0.0
A16167,1,0,0,1,1.0,0.0,0.0
A16168,2,2,0,4,0.5,0.5,0.0
A16169,6,19,0,25,0.24,0.76,0.0
A16170,3,5,0,8,0.38,0.62,0.0
A16172,5,11,0,16,0.31,0.69,0.0
A16173,11,22,0,33,0.33,0.67,0.0
A16174,7,17,0,24,0.29,0.71,0.0
A16175,382,383,8,773,0.49,0.5,0.01
A16176,19,17,0,36,0.53,0.47,0.0
A16177,9,10,0,19,0.47,0.53,0.0
A16178,2,1,0,3,0.67,0.33,0.0
A16179,3,9,0,12,0.25,0.75,0.0
A16180,0,2,0,2,0.0,1.0,0.0
A16181,1,1,0,2,0.5,0.5,0.0
A16182,3,3,0,6,0.5,0.5,0.0
A16183,2,2,0,4,0.5,0.5,0.0
A16184,0,1,0,1,0.0,1.0,0.0
A16185,0,1,0,1,0.0,1.0,0.0
A16187,4,7,0,11,0.36,0.64,0.0
A16188,1,3,0,4,0.25,0.75,0.0
A16190,3,15,0,18,0.17,0.83,0.0
A16191,12,4,0,16,0.75,0.25,0.0
A16192,1,14,0,15,0.07,0.93,0.0
A16193,17,13,0,30,0.57,0.43,0.0
A16194,12,23,0,35,0.34,0.66,0.0
A16195,8,13,0,21,0.38,0.62,0.0
A16196,7,7,1,15,0.47,0.47,0.07
A16197,1,2,0,3,0.33,0.67,0.0
A16198,13,40,1,54,0.24,0.74,0.02
A16200,8,13,0,21,0.38,0.62,0.0
A16201,2,0,1,3,0.67,0.0,0.33
A16202,16,8,0,24,0.67,0.33,0.0
A16203,1,0,0,1,1.0,0.0,0.0
A16204,5,3,0,8,0.62,0.38,0.0
A16205,3,13,0,16,0.19,0.81,0.0
A16206,0,1,0,1,0.0,1.0,0.0
A16207,2,2,0,4,0.5,0.5,0.0
A16208,5,3,0,8,0.62,0.38,0.0
A16211,4,5,0,9,0.44,0.56,0.0
A16212,6,1,1,8,0.75,0.12,0.12
A16213,0,2,0,2,0.0,1.0,0.0
A16214,26,14,0,40,0.65,0.35,0.0
A16215,23,25,2,50,0.46,0.5,0.04
A16216,3,10,0,13,0.23,0.77,0.0
A16217,1,0,0,1,1.0,0.0,0.0
A16218,0,3,0,3,0.0,1.0,0.0
A16220,19,20,0,39,0.49,0.51,0.0
A16227,0,5,0,5,0.0,1.0,0.0
A16228,1,1,0,2,0.5,0.5,0.0
A16229,1,0,1,2,0.5,0.0,0.5
A16232,12,2,1,15,0.8,0.13,0.07
A16233,1,2,0,3,0.33,0.67,0.0
A16234,1,4,0,5,0.2,0.8,0.0
A16235,8,3,1,12,0.67,0.25,0.08
A16236,5,18,0,23,0.22,0.78,0.0
A16237,3,3,0,6,0.5,0.5,0.0
A16239,0,1,0,1,0.0,1.0,0.0
A16240,5,3,0,8,0.62,0.38,0.0
A16242,8,5,0,13,0.62,0.38,0.0
A16243,2,2,0,4,0.5,0.5,0.0
A16244,4,2,0,6,0.67,0.33,0.0
A16245,1,1,0,2,0.5,0.5,0.0
A16246,37,16,6,59,0.63,0.27,0.1
A16247,0,6,0,6,0.0,1.0,0.0
A16251,0,6,0,6,0.0,1.0,0.0
A16252,2,5,0,7,0.29,0.71,0.0
A16253,2,12,0,14,0.14,0.86,0.0
A16254,2,5,0,7,0.29,0.71,0.0
A16256,0,1,0,1,0.0,1.0,0.0
A16257,0,1,0,1,0.0,1.0,0.0
A16258,2,11,0,13,0.15,0.85,0.0
A16260,1,3,0,4,0.25,0.75,0.0
A16261,0,4,0,4,0.0,1.0,0.0
A16262,4,6,0,10,0.4,0.6,0.0
A16263,15,11,0,26,0.58,0.42,0.0
A16265,33,10,0,43,0.77,0.23,0.0
A16266,5,4,0,9,0.56,0.44,0.0
A16267,0,2,0,2,0.0,1.0,0.0
A16268,1,3,1,5,0.2,0.6,0.2
A16270,0,2,0,2,0.0,1.0,0.0
A16273,0,3,0,3,0.0,1.0,0.0
A16274,6,10,2,18,0.33,0.56,0.11
A16277,1,3,0,4,0.25,0.75,0.0
A16279,1,1,0,2,0.5,0.5,0.0
A16280,18,7,0,25,0.72,0.28,0.0
A16281,10,3,0,13,0.77,0.23,0.0
A16282,2,7,0,9,0.22,0.78,0.0
A16286,18,45,0,63,0.29,0.71,0.0
A16288,35,129,0,164,0.21,0.79,0.0
A16289,10,20,0,30,0.33,0.67,0.0
A16290,13,27,0,40,0.33,0.68,0.0
A16292,1,1,0,2,0.5,0.5,0.0
A16293,1,3,0,4,0.25,0.75,0.0
A16294,3,4,0,7,0.43,0.57,0.0
A16295,2,1,0,3,0.67,0.33,0.0
A16296,4,6,0,10,0.4,0.6,0.0
A16297,3,7,0,10,0.3,0.7,0.0
A16299,0,3,0,3,0.0,1.0,0.0
A16300,7,22,1,30,0.23,0.73,0.03
A16301,9,2,0,11,0.82,0.18,0.0
A16302,0,2,0,2,0.0,1.0,0.0
A16303,2,5,0,7,0.29,0.71,0.0
A16304,0,2,0,2,0.0,1.0,0.0
A16305,3,2,0,5,0.6,0.4,0.0
A16306,5,11,0,16,0.31,0.69,0.0
A16307,4,4,0,8,0.5,0.5,0.0
A16309,6,16,1,23,0.26,0.7,0.04
A16310,1,1,0,2,0.5,0.5,0.0
A16311,0,1,0,1,0.0,1.0,0.0
A16312,1,13,0,14,0.07,0.93,0.0
A16313,2,1,4,7,0.29,0.14,0.57
A16314,1,2,0,3,0.33,0.67,0.0
A16315,4,8,0,12,0.33,0.67,0.0
A16316,195,598,15,808,0.24,0.74,0.02
A16317,27,135,0,162,0.17,0.83,0.0
A16318,37,164,0,201,0.18,0.82,0.0
A16319,7,19,0,26,0.27,0.73,0.0
A16320,6,21,0,27,0.22,0.78,0.0
A16321,1,9,3,13,0.08,0.69,0.23
A16322,40,45,2,87,0.46,0.52,0.02
A16323,28,115,0,143,0.2,0.8,0.0
A16324,22,24,2,48,0.46,0.5,0.04
A16325,29,29,1,59,0.49,0.49,0.02
A16326,18,18,1,37,0.49,0.49,0.03
A16327,5,12,0,17,0.29,0.71,0.0
A16328,1,0,0,1,1.0,0.0,0.0
A16329,2,1,0,3,0.67,0.33,0.0
A16330,3,5,0,8,0.38,0.62,0.0
A16331,2,6,0,8,0.25,0.75,0.0
A16332,1,5,0,6,0.17,0.83,0.0
A16333,1,3,0,4,0.25,0.75,0.0
A16334,1,1,0,2,0.5,0.5,0.0
A16335,0,6,0,6,0.0,1.0,0.0
A16336,4,24,0,28,0.14,0.86,0.0
A16337,7,19,0,26,0.27,0.73,0.0
A16338,1,12,0,13,0.08,0.92,0.0
A16339,18,25,1,44,0.41,0.57,0.02
A16340,2,5,0,7,0.29,0.71,0.0
A16342,0,7,0,7,0.0,1.0,0.0
A16343,5,5,0,10,0.5,0.5,0.0
A16344,11,22,0,33,0.33,0.67,0.0
A16345,6,3,0,9,0.67,0.33,0.0
A16346,6,3,0,9,0.67,0.33,0.0
A16347,1,0,0,1,1.0,0.0,0.0
A16348,5,7,0,12,0.42,0.58,0.0
A16349,3,26,0,29,0.1,0.9,0.0
A16350,2,9,0,11,0.18,0.82,0.0
A16351,12,15,0,27,0.44,0.56,0.0
A16352,0,6,0,6,0.0,1.0,0.0
A16353,22,21,0,43,0.51,0.49,0.0
A16354,19,12,15,46,0.41,0.26,0.33
A16355,16,6,0,22,0.73,0.27,0.0
A16356,1,11,0,12,0.08,0.92,0.0
A16357,0,2,0,2,0.0,1.0,0.0
A16358,4,18,1,23,0.17,0.78,0.04
A16359,4,7,0,11,0.36,0.64,0.0
A16360,7,3,3,13,0.54,0.23,0.23
A16361,8,9,0,17,0.47,0.53,0.0
A16362,6,14,0,20,0.3,0.7,0.0
A16363,1,1,0,2,0.5,0.5,0.0
A16364,9,18,0,27,0.33,0.67,0.0
A16365,5,7,0,12,0.42,0.58,0.0
A16366,35,29,0,64,0.55,0.45,0.0
A16367,1,1,0,2,0.5,0.5,0.0
A16368,12,16,0,28,0.43,0.57,0.0
A16369,3,16,0,19,0.16,0.84,0.0
A16370,3,8,0,11,0.27,0.73,0.0
A16371,0,2,0,2,0.0,1.0,0.0
A16372,1,6,0,7,0.14,0.86,0.0
A16373,3,1,0,4,0.75,0.25,0.0
A16374,3,2,0,5,0.6,0.4,0.0
A16375,18,14,0,32,0.56,0.44,0.0
A16376,10,58,0,68,0.15,0.85,0.0
A16377,44,22,0,66,0.67,0.33,0.0
A16378,4,3,0,7,0.57,0.43,0.0
A16379,1,1,0,2,0.5,0.5,0.0
A16380,2,2,1,5,0.4,0.4,0.2
A16381,2,3,0,5,0.4,0.6,0.0
A16383,39,583,6,628,0.06,0.93,0.01
A16386,0,2,0,2,0.0,1.0,0.0
A16387,1,1,0,2,0.5,0.5,0.0
A16388,0,2,0,2,0.0,1.0,0.0
A16390,0,0,1,1,0.0,0.0,1.0
A16391,0,0,1,1,0.0,0.0,1.0
A16393,0,1,0,1,0.0,1.0,0.0
A16394,0,2,0,2,0.0,1.0,0.0
A16395,11,15,0,26,0.42,0.58,0.0
A16396,17,108,0,125,0.14,0.86,0.0
A16397,0,1,0,1,0.0,1.0,0.0
A16398,21,28,0,49,0.43,0.57,0.0
A16399,0,3,0,3,0.0,1.0,0.0
A16400,0,2,0,2,0.0,1.0,0.0
A16401,0,5,0,5,0.0,1.0,0.0
A16402,6,7,0,13,0.46,0.54,0.0
A16403,0,1,0,1,0.0,1.0,0.0
A16406,22,44,4,70,0.31,0.63,0.06
A16407,15,41,0,56,0.27,0.73,0.0
A16408,39,56,0,95,0.41,0.59,0.0
A16409,0,2,0,2,0.0,1.0,0.0
A16411,16,17,0,33,0.48,0.52,0.0
A16412,2,8,0,10,0.2,0.8,0.0
A16413,0,4,0,4,0.0,1.0,0.0
A16414,10,38,2,50,0.2,0.76,0.04
A16415,28,34,3,65,0.43,0.52,0.05
A16417,0,0,1,1,0.0,0.0,1.0
A16418,17,19,0,36,0.47,0.53,0.0
A16421,2,1,0,3,0.67,0.33,0.0
A16422,6,0,0,6,1.0,0.0,0.0
A16424,0,2,0,2,0.0,1.0,0.0
A16425,0,8,0,8,0.0,1.0,0.0
A16426,4,1,0,5,0.8,0.2,0.0
A16428,1,4,0,5,0.2,0.8,0.0
A16429,14,14,0,28,0.5,0.5,0.0
A16430,9,14,0,23,0.39,0.61,0.0
A16431,0,2,0,2,0.0,1.0,0.0
A16432,3,7,0,10,0.3,0.7,0.0
A16433,1,1,0,2,0.5,0.5,0.0
A16434,7,17,1,25,0.28,0.68,0.04
A16435,61,36,3,100,0.61,0.36,0.03
A16436,1,4,0,5,0.2,0.8,0.0
A16437,3,3,0,6,0.5,0.5,0.0
A16438,27,24,2,53,0.51,0.45,0.04
A16439,7,8,0,15,0.47,0.53,0.0
A16440,2,1,0,3,0.67,0.33,0.0
A16441,4,3,0,7,0.57,0.43,0.0
A16442,2,6,0,8,0.25,0.75,0.0
A16443,18,25,2,45,0.4,0.56,0.04
A16445,5,5,0,10,0.5,0.5,0.0
A16446,1,4,0,5,0.2,0.8,0.0
A16447,7,9,0,16,0.44,0.56,0.0
A16448,0,1,0,1,0.0,1.0,0.0
A16450,3,7,0,10,0.3,0.7,0.0
A16451,2,15,1,18,0.11,0.83,0.06
A16452,10,31,0,41,0.24,0.76,0.0
A16453,2,4,0,6,0.33,0.67,0.0
A16454,8,10,0,18,0.44,0.56,0.0
A16456,32,17,0,49,0.65,0.35,0.0
A16458,8,16,0,24,0.33,0.67,0.0
A16459,0,1,0,1,0.0,1.0,0.0
A16460,6,17,0,23,0.26,0.74,0.0
A16461,4,4,0,8,0.5,0.5,0.0
A16463,72,63,0,135,0.53,0.47,0.0
A16464,7,7,0,14,0.5,0.5,0.0
A16465,12,10,0,22,0.55,0.45,0.0
A16466,3,6,0,9,0.33,0.67,0.0
A16467,0,2,0,2,0.0,1.0,0.0
A16468,1,6,0,7,0.14,0.86,0.0
A16469,4,6,0,10,0.4,0.6,0.0
A16470,3,1,0,4,0.75,0.25,0.0
A16471,1,0,0,1,1.0,0.0,0.0
A16472,0,1,0,1,0.0,1.0,0.0
A16474,5,8,0,13,0.38,0.62,0.0
A16475,21,15,0,36,0.58,0.42,0.0
A16476,0,2,0,2,0.0,1.0,0.0
A16477,3,12,1,16,0.19,0.75,0.06
A16478,1,0,0,1,1.0,0.0,0.0
A16479,2,0,0,2,1.0,0.0,0.0
A16480,11,15,1,27,0.41,0.56,0.04
A16481,1,2,0,3,0.33,0.67,0.0
A16482,0,3,0,3,0.0,1.0,0.0
A16483,12,19,0,31,0.39,0.61,0.0
A16484,2,10,0,12,0.17,0.83,0.0
A16485,0,2,0,2,0.0,1.0,0.0
A16486,0,1,0,1,0.0,1.0,0.0
A16487,10,17,0,27,0.37,0.63,0.0
A16488,2,3,0,5,0.4,0.6,0.0
A16489,1,0,1,2,0.5,0.0,0.5
A16490,12,22,0,34,0.35,0.65,0.0
A16491,0,2,0,2,0.0,1.0,0.0
A16492,3,8,0,11,0.27,0.73,0.0
A16493,0,2,0,2,0.0,1.0,0.0
A16494,0,1,0,1,0.0,1.0,0.0
A16495,0,4,0,4,0.0,1.0,0.0
A16496,21,28,0,49,0.43,0.57,0.0
A16497,8,13,0,21,0.38,0.62,0.0
A16498,0,1,0,1,0.0,1.0,0.0
A16499,1,2,0,3,0.33,0.67,0.0
A16500,0,3,0,3,0.0,1.0,0.0
A16501,17,20,3,40,0.42,0.5,0.07
A16502,5,4,0,9,0.56,0.44,0.0
A16503,4,3,1,8,0.5,0.38,0.12
A16504,1,2,0,3,0.33,0.67,0.0
A16505,5,6,0,11,0.45,0.55,0.0
A16506,18,16,0,34,0.53,0.47,0.0
A16507,3,26,0,29,0.1,0.9,0.0
A16508,13,17,0,30,0.43,0.57,0.0
A16509,24,51,0,75,0.32,0.68,0.0
A16510,1,1,0,2,0.5,0.5,0.0
A16511,9,9,8,26,0.35,0.35,0.31
A16512,3,16,0,19,0.16,0.84,0.0
A16513,22,114,0,136,0.16,0.84,0.0
A16514,0,1,0,1,0.0,1.0,0.0
A16515,5,15,0,20,0.25,0.75,0.0
A16516,14,16,0,30,0.47,0.53,0.0
A16517,1,2,0,3,0.33,0.67,0.0
A16518,1,6,0,7,0.14,0.86,0.0
A16519,1,3,0,4,0.25,0.75,0.0
A16520,2,7,0,9,0.22,0.78,0.0
A16521,13,14,0,27,0.48,0.52,0.0
A16522,635,779,84,1498,0.42,0.52,0.06
A16523,11,127,0,138,0.08,0.92,0.0
A16524,119,154,0,273,0.44,0.56,0.0
A16525,23,23,0,46,0.5,0.5,0.0
A16526,1,1,0,2,0.5,0.5,0.0
A16527,8,17,0,25,0.32,0.68,0.0
A16528,54,43,0,97,0.56,0.44,0.0
A16529,8,4,0,12,0.67,0.33,0.0
A16530,43,35,1,79,0.54,0.44,0.01
A16531,0,1,0,1,0.0,1.0,0.0
A16532,2,0,0,2,1.0,0.0,0.0
A16533,24,15,25,64,0.38,0.23,0.39
A16534,8,15,1,24,0.33,0.62,0.04
A16535,1,0,0,1,1.0,0.0,0.0
A16537,0,3,0,3,0.0,1.0,0.0
A16538,7,12,0,19,0.37,0.63,0.0
A16539,15,9,1,25,0.6,0.36,0.04
A16540,3,3,0,6,0.5,0.5,0.0
A16541,3,13,1,17,0.18,0.76,0.06
A16542,25,19,1,45,0.56,0.42,0.02
A16543,5,6,0,11,0.45,0.55,0.0
A16544,1,3,0,4,0.25,0.75,0.0
A16545,7,7,0,14,0.5,0.5,0.0
A16546,1,2,0,3,0.33,0.67,0.0
A16547,13,7,0,20,0.65,0.35,0.0
A16548,3,5,0,8,0.38,0.62,0.0
A16549,12,7,10,29,0.41,0.24,0.34
A16550,1,1,0,2,0.5,0.5,0.0
A16551,6,5,0,11,0.55,0.45,0.0
A16552,1,3,0,4,0.25,0.75,0.0
A16553,8,5,0,13,0.62,0.38,0.0
A16554,48,18,1,67,0.72,0.27,0.01
A16556,3,10,0,13,0.23,0.77,0.0
A16560,0,1,0,1,0.0,1.0,0.0
A16561,0,1,0,1,0.0,1.0,0.0
A16563,1,0,0,1,1.0,0.0,0.0
A16564,6,6,0,12,0.5,0.5,0.0
A16565,122,32,2,156,0.78,0.21,0.01
A16566,9,2,0,11,0.82,0.18,0.0
A16567,1,1,0,2,0.5,0.5,0.0
A16569,7,6,0,13,0.54,0.46,0.0
A16570,5,13,0,18,0.28,0.72,0.0
A16571,0,1,1,2,0.0,0.5,0.5
A16572,3,6,1,10,0.3,0.6,0.1
A16573,2,4,0,6,0.33,0.67,0.0
A16574,8,12,0,20,0.4,0.6,0.0
A16575,16,7,0,23,0.7,0.3,0.0
A16576,1,2,0,3,0.33,0.67,0.0
A16577,6,6,1,13,0.46,0.46,0.08
A16578,4,12,0,16,0.25,0.75,0.0
A16581,0,2,0,2,0.0,1.0,0.0
A16582,0,1,0,1,0.0,1.0,0.0
A16583,28,19,0,47,0.6,0.4,0.0
A16584,10,14,1,25,0.4,0.56,0.04
A16585,33,26,0,59,0.56,0.44,0.0
A16586,0,4,0,4,0.0,1.0,0.0
A16587,3,1,0,4,0.75,0.25,0.0
A16588,3,6,0,9,0.33,0.67,0.0
A16589,1,1,0,2,0.5,0.5,0.0
A16590,0,4,0,4,0.0,1.0,0.0
A16591,4,6,0,10,0.4,0.6,0.0
A16592,10,18,0,28,0.36,0.64,0.0
A16593,0,5,0,5,0.0,1.0,0.0
A16594,3,3,2,8,0.38,0.38,0.25
A16595,5,7,1,13,0.38,0.54,0.08
A16596,2,7,0,9,0.22,0.78,0.0
A16597,1,0,0,1,1.0,0.0,0.0
A16598,3,1,0,4,0.75,0.25,0.0
A16600,1,8,0,9,0.11,0.89,0.0
A16601,35,24,0,59,0.59,0.41,0.0
A16602,23,37,0,60,0.38,0.62,0.0
A16603,1,9,0,10,0.1,0.9,0.0
A16604,2,4,0,6,0.33,0.67,0.0
A16605,1,0,0,1,1.0,0.0,0.0
A16606,4,2,0,6,0.67,0.33,0.0
A16607,4,11,0,15,0.27,0.73,0.0
A16608,3,8,0,11,0.27,0.73,0.0
A16609,4,2,0,6,0.67,0.33,0.0
A16610,18,17,2,37,0.49,0.46,0.05
A16611,2,4,0,6,0.33,0.67,0.0
A16612,1,0,0,1,1.0,0.0,0.0
A16613,7,15,0,22,0.32,0.68,0.0
A16614,22,6,0,28,0.79,0.21,0.0
A16616,0,1,0,1,0.0,1.0,0.0
A16617,0,2,0,2,0.0,1.0,0.0
A16618,4,3,0,7,0.57,0.43,0.0
A16619,3,6,0,9,0.33,0.67,0.0
A16620,0,1,0,1,0.0,1.0,0.0
A16621,8,6,0,14,0.57,0.43,0.0
A16622,0,2,0,2,0.0,1.0,0.0
A16623,3,17,0,20,0.15,0.85,0.0
A16624,2,8,1,11,0.18,0.73,0.09
A16625,0,1,0,1,0.0,1.0,0.0
A16627,2,1,0,3,0.67,0.33,0.0
A16628,11,12,1,24,0.46,0.5,0.04
A16629,10,4,0,14,0.71,0.29,0.0
A16632,6,19,1,26,0.23,0.73,0.04
A16635,22,22,1,45,0.49,0.49,0.02
A16636,6,8,0,14,0.43,0.57,0.0
A16639,8,14,0,22,0.36,0.64,0.0
A16641,9,16,0,25,0.36,0.64,0.0
A16642,5,12,0,17,0.29,0.71,0.0
A16643,3,11,0,14,0.21,0.79,0.0
A16644,0,4,0,4,0.0,1.0,0.0
A16645,8,12,1,21,0.38,0.57,0.05
A16646,0,1,0,1,0.0,1.0,0.0
A16647,0,10,1,11,0.0,0.91,0.09
A16648,3,4,1,8,0.38,0.5,0.12
A16649,1,0,0,1,1.0,0.0,0.0
A16650,3,7,0,10,0.3,0.7,0.0
A16651,2,1,0,3,0.67,0.33,0.0
A16652,1,0,0,1,1.0,0.0,0.0
A16653,0,1,0,1,0.0,1.0,0.0
A16654,159,313,10,482,0.33,0.65,0.02
A16655,0,8,0,8,0.0,1.0,0.0
A16656,2,2,0,4,0.5,0.5,0.0
A16657,1,5,0,6,0.17,0.83,0.0
A16658,25,18,4,47,0.53,0.38,0.09
A16659,2,3,0,5,0.4,0.6,0.0
A16660,0,3,0,3,0.0,1.0,0.0
A16661,205,295,5,505,0.41,0.58,0.01
A16662,0,3,0,3,0.0,1.0,0.0
A16663,1,0,0,1,1.0,0.0,0.0
A16664,0,0,1,1,0.0,0.0,1.0
A16665,4,2,2,8,0.5,0.25,0.25
A16666,2,1,0,3,0.67,0.33,0.0
A16667,0,3,0,3,0.0,1.0,0.0
A16669,5,6,0,11,0.45,0.55,0.0
A16670,0,4,0,4,0.0,1.0,0.0
A16671,0,1,0,1,0.0,1.0,0.0
A16673,170,299,3,472,0.36,0.63,0.01
A16674,9,6,0,15,0.6,0.4,0.0
A16675,34,39,0,73,0.47,0.53,0.0
A16676,6,110,0,116,0.05,0.95,0.0
A16677,10,35,0,45,0.22,0.78,0.0
A16678,3,6,0,9,0.33,0.67,0.0
A16679,1,10,0,11,0.09,0.91,0.0
A16680,0,2,0,2,0.0,1.0,0.0
A16681,0,1,0,1,0.0,1.0,0.0
A16682,0,11,0,11,0.0,1.0,0.0
A16683,5,2,1,8,0.62,0.25,0.12
A16684,14,25,0,39,0.36,0.64,0.0
A16685,45,50,1,96,0.47,0.52,0.01
A16686,4,1,0,5,0.8,0.2,0.0
A16687,4,2,0,6,0.67,0.33,0.0
A16688,10,4,0,14,0.71,0.29,0.0
A16689,9,13,0,22,0.41,0.59,0.0
A16690,25,24,0,49,0.51,0.49,0.0
A16691,1,2,0,3,0.33,0.67,0.0
A16692,2,3,0,5,0.4,0.6,0.0
A16693,0,6,0,6,0.0,1.0,0.0
A16694,18,18,0,36,0.5,0.5,0.0
A16695,37,41,0,78,0.47,0.53,0.0
A16696,0,9,0,9,0.0,1.0,0.0
A16697,7,24,0,31,0.23,0.77,0.0
A16698,27,14,0,41,0.66,0.34,0.0
A16699,1,2,2,5,0.2,0.4,0.4
A16700,1,0,0,1,1.0,0.0,0.0
A16702,40,18,0,58,0.69,0.31,0.0
A16703,1,1,2,4,0.25,0.25,0.5
A16704,18,19,1,38,0.47,0.5,0.03
A16705,25,18,0,43,0.58,0.42,0.0
A16706,1,5,0,6,0.17,0.83,0.0
A16708,33,25,0,58,0.57,0.43,0.0
A16709,1,5,0,6,0.17,0.83,0.0
A16712,6,3,0,9,0.67,0.33,0.0
A16714,4,2,0,6,0.67,0.33,0.0
A16715,5,3,0,8,0.62,0.38,0.0
A16716,1,18,0,19,0.05,0.95,0.0
A16717,2,1,0,3,0.67,0.33,0.0
A16718,13,16,0,29,0.45,0.55,0.0
A16719,4,4,0,8,0.5,0.5,0.0
A16720,4,7,0,11,0.36,0.64,0.0
A16721,1,2,0,3,0.33,0.67,0.0
A16722,9,4,1,14,0.64,0.29,0.07
A16723,54,30,0,84,0.64,0.36,0.0
A16724,12,5,1,18,0.67,0.28,0.06
A16725,3,2,2,7,0.43,0.29,0.29
A16726,16,27,1,44,0.36,0.61,0.02
A16727,2,2,0,4,0.5,0.5,0.0
A16728,0,1,0,1,0.0,1.0,0.0
A16729,8,9,0,17,0.47,0.53,0.0
A16730,17,34,0,51,0.33,0.67,0.0
A16731,3,5,0,8,0.38,0.62,0.0
A16732,1,2,0,3,0.33,0.67,0.0
A16733,5,3,0,8,0.62,0.38,0.0
A16734,1,2,0,3,0.33,0.67,0.0
A16735,2,0,0,2,1.0,0.0,0.0
A16736,15,17,0,32,0.47,0.53,0.0
A16737,0,2,2,4,0.0,0.5,0.5
A16738,9,6,0,15,0.6,0.4,0.0
A16740,16,22,0,38,0.42,0.58,0.0
A16741,0,0,1,1,0.0,0.0,1.0
A16742,5,4,0,9,0.56,0.44,0.0
A16743,9,16,0,25,0.36,0.64,0.0
A16744,2,2,1,5,0.4,0.4,0.2
A16745,21,12,1,34,0.62,0.35,0.03
A16746,17,20,0,37,0.46,0.54,0.0
A16747,0,2,0,2,0.0,1.0,0.0
A16748,7,11,0,18,0.39,0.61,0.0
A16749,0,7,0,7,0.0,1.0,0.0
A16750,66,36,6,108,0.61,0.33,0.06
A16751,3,5,0,8,0.38,0.62,0.0
A16753,1,2,0,3,0.33,0.67,0.0
A16754,1,2,0,3,0.33,0.67,0.0
A16756,9,6,0,15,0.6,0.4,0.0
A16757,14,9,0,23,0.61,0.39,0.0
A16758,3,5,1,9,0.33,0.56,0.11
A16760,2,9,0,11,0.18,0.82,0.0
A16762,5,4,0,9,0.56,0.44,0.0
A16763,4,5,0,9,0.44,0.56,0.0
A16764,9,9,0,18,0.5,0.5,0.0
A16765,16,11,1,28,0.57,0.39,0.04
A16766,0,4,0,4,0.0,1.0,0.0
A16768,0,1,0,1,0.0,1.0,0.0
A16769,2,6,0,8,0.25,0.75,0.0
A16770,10,14,1,25,0.4,0.56,0.04
A16771,4,6,0,10,0.4,0.6,0.0
A16772,6,9,0,15,0.4,0.6,0.0
A16773,19,5,0,24,0.79,0.21,0.0
A16774,1,3,0,4,0.25,0.75,0.0
A16775,1,4,0,5,0.2,0.8,0.0
A16776,2,5,0,7,0.29,0.71,0.0
A16777,2,5,0,7,0.29,0.71,0.0
A16778,9,8,0,17,0.53,0.47,0.0
A16780,1,13,0,14,0.07,0.93,0.0
A16781,5,3,0,8,0.62,0.38,0.0
A16782,1,1,0,2,0.5,0.5,0.0
A16783,1,0,0,1,1.0,0.0,0.0
A16784,0,1,0,1,0.0,1.0,0.0
A16785,77,75,0,152,0.51,0.49,0.0
A16786,1,9,1,11,0.09,0.82,0.09
A16789,0,1,0,1,0.0,1.0,0.0
A16790,44,92,2,138,0.32,0.67,0.01
A16791,8,8,0,16,0.5,0.5,0.0
A16793,0,1,0,1,0.0,1.0,0.0
A16794,13,15,0,28,0.46,0.54,0.0
A16795,23,13,1,37,0.62,0.35,0.03
A16796,0,2,0,2,0.0,1.0,0.0
A16797,3,18,0,21,0.14,0.86,0.0
A16798,1,3,0,4,0.25,0.75,0.0
A16799,6,3,0,9,0.67,0.33,0.0
A16800,0,3,0,3,0.0,1.0,0.0
A16801,4,13,2,19,0.21,0.68,0.11
A16802,7,9,0,16,0.44,0.56,0.0
A16804,2,1,0,3,0.67,0.33,0.0
A16805,0,4,0,4,0.0,1.0,0.0
A16806,19,7,4,30,0.63,0.23,0.13
A16807,31,20,0,51,0.61,0.39,0.0
A16808,1,5,0,6,0.17,0.83,0.0
A16809,0,1,0,1,0.0,1.0,0.0
A16810,4,4,0,8,0.5,0.5,0.0
A16811,9,19,0,28,0.32,0.68,0.0
A16812,0,0,1,1,0.0,0.0,1.0
A16813,0,3,0,3,0.0,1.0,0.0
A16815,0,14,0,14,0.0,1.0,0.0
A16816,3,5,0,8,0.38,0.62,0.0
A16819,1,6,0,7,0.14,0.86,0.0
A16820,1,2,0,3,0.33,0.67,0.0
A16822,2,2,0,4,0.5,0.5,0.0
A16823,1,6,0,7,0.14,0.86,0.0
A16827,4,1,0,5,0.8,0.2,0.0
A16828,19,12,0,31,0.61,0.39,0.0
A16829,0,2,0,2,0.0,1.0,0.0
A16831,0,1,0,1,0.0,1.0,0.0
A16832,8,8,0,16,0.5,0.5,0.0
A16833,2,3,0,5,0.4,0.6,0.0
A16834,3,3,0,6,0.5,0.5,0.0
A16835,0,1,0,1,0.0,1.0,0.0
A16837,0,1,0,1,0.0,1.0,0.0
A16842,8,15,0,23,0.35,0.65,0.0
A16843,5,14,0,19,0.26,0.74,0.0
A16844,9,8,0,17,0.53,0.47,0.0
A16845,1,3,0,4,0.25,0.75,0.0
A16847,2,3,0,5,0.4,0.6,0.0
A16848,31,27,0,58,0.53,0.47,0.0
A16849,9,4,4,17,0.53,0.24,0.24
A16850,9,5,0,14,0.64,0.36,0.0
A16851,0,2,0,2,0.0,1.0,0.0
A16853,4,14,1,19,0.21,0.74,0.05
A16855,0,1,0,1,0.0,1.0,0.0
A16856,6,6,5,17,0.35,0.35,0.29
A16858,11,14,0,25,0.44,0.56,0.0
A16859,1,2,0,3,0.33,0.67,0.0
A16860,9,10,0,19,0.47,0.53,0.0
A16861,0,6,0,6,0.0,1.0,0.0
A16862,0,3,0,3,0.0,1.0,0.0
A16863,0,2,1,3,0.0,0.67,0.33
A16864,2,3,0,5,0.4,0.6,0.0
A16866,2,2,0,4,0.5,0.5,0.0
A16869,0,1,0,1,0.0,1.0,0.0
A16870,0,1,0,1,0.0,1.0,0.0
A16871,26,18,0,44,0.59,0.41,0.0
A16872,1,0,0,1,1.0,0.0,0.0
A16873,0,3,0,3,0.0,1.0,0.0
A16874,3,23,0,26,0.12,0.88,0.0
A16876,0,1,1,2,0.0,0.5,0.5
A16877,0,1,0,1,0.0,1.0,0.0
A16878,5,1,0,6,0.83,0.17,0.0
A16879,5,1,0,6,0.83,0.17,0.0
A16880,0,1,0,1,0.0,1.0,0.0
A16881,2,6,0,8,0.25,0.75,0.0
A16882,42,49,0,91,0.46,0.54,0.0
A16884,3,15,1,19,0.16,0.79,0.05
A16887,20,10,0,30,0.67,0.33,0.0
A16888,4,6,0,10,0.4,0.6,0.0
A16889,0,4,0,4,0.0,1.0,0.0
A16890,36,22,0,58,0.62,0.38,0.0
A16891,12,22,0,34,0.35,0.65,0.0
A16894,1,6,0,7,0.14,0.86,0.0
A16896,5,13,0,18,0.28,0.72,0.0
A16898,0,1,0,1,0.0,1.0,0.0
A16900,1,0,0,1,1.0,0.0,0.0
A16901,0,3,0,3,0.0,1.0,0.0
A16905,1,8,0,9,0.11,0.89,0.0
A16906,0,2,0,2,0.0,1.0,0.0
A16907,0,1,0,1,0.0,1.0,0.0
A16908,13,55,0,68,0.19,0.81,0.0
A16909,0,2,0,2,0.0,1.0,0.0
A16912,4,3,0,7,0.57,0.43,0.0
A16917,16,8,0,24,0.67,0.33,0.0
A16918,2,1,0,3,0.67,0.33,0.0
A16919,2,7,0,9,0.22,0.78,0.0
A16920,28,20,1,49,0.57,0.41,0.02
A16921,10,15,0,25,0.4,0.6,0.0
A16923,5,12,0,17,0.29,0.71,0.0
A16926,0,1,0,1,0.0,1.0,0.0
A16927,11,4,0,15,0.73,0.27,0.0
A16928,2,5,0,7,0.29,0.71,0.0
A16929,90,110,4,204,0.44,0.54,0.02
A16931,1,1,2,4,0.25,0.25,0.5
A16933,0,1,0,1,0.0,1.0,0.0
A16934,0,1,1,2,0.0,0.5,0.5
A16935,1,1,0,2,0.5,0.5,0.0
A16937,12,5,0,17,0.71,0.29,0.0
A16940,6,1,0,7,0.86,0.14,0.0
A16941,0,1,0,1,0.0,1.0,0.0
A16942,12,7,0,19,0.63,0.37,0.0
A16943,18,16,0,34,0.53,0.47,0.0
A16945,1,2,0,3,0.33,0.67,0.0
A16946,9,4,0,13,0.69,0.31,0.0
A16947,0,1,0,1,0.0,1.0,0.0
A16949,1,2,0,3,0.33,0.67,0.0
A16950,3,7,0,10,0.3,0.7,0.0
A16951,5,6,0,11,0.45,0.55,0.0
A16952,0,1,0,1,0.0,1.0,0.0
A16953,9,6,0,15,0.6,0.4,0.0
A16954,0,4,0,4,0.0,1.0,0.0
A16956,5,1,0,6,0.83,0.17,0.0
A16957,1,2,0,3,0.33,0.67,0.0
A16958,0,1,0,1,0.0,1.0,0.0
A16959,13,16,0,29,0.45,0.55,0.0
A16960,1,6,0,7,0.14,0.86,0.0
A16961,0,1,0,1,0.0,1.0,0.0
A16962,13,14,1,28,0.46,0.5,0.04
A16963,2,2,0,4,0.5,0.5,0.0
A16967,2,4,0,6,0.33,0.67,0.0
A16968,1,2,0,3,0.33,0.67,0.0
A16969,1,3,0,4,0.25,0.75,0.0
A16970,11,10,0,21,0.52,0.48,0.0
A16971,2,3,1,6,0.33,0.5,0.17
A16974,11,11,0,22,0.5,0.5,0.0
A16975,5,1,0,6,0.83,0.17,0.0
A16978,16,11,0,27,0.59,0.41,0.0
A16979,1,0,0,1,1.0,0.0,0.0
A16980,2,5,0,7,0.29,0.71,0.0
A16981,2,2,0,4,0.5,0.5,0.0
A16982,0,1,0,1,0.0,1.0,0.0
A16983,2,2,0,4,0.5,0.5,0.0
A16984,10,21,0,31,0.32,0.68,0.0
A16985,0,1,0,1,0.0,1.0,0.0
A16987,0,7,0,7,0.0,1.0,0.0
A16988,1,7,0,8,0.12,0.88,0.0
A16989,0,3,0,3,0.0,1.0,0.0
A16990,8,20,0,28,0.29,0.71,0.0
A16991,1,10,0,11,0.09,0.91,0.0
A16992,4,29,0,33,0.12,0.88,0.0
A16993,3,0,0,3,1.0,0.0,0.0
A16994,20,23,0,43,0.47,0.53,0.0
A16995,2,4,0,6,0.33,0.67,0.0
A16997,1,4,0,5,0.2,0.8,0.0
A16998,1,9,0,10,0.1,0.9,0.0
A16999,3,2,0,5,0.6,0.4,0.0
A17000,11,12,0,23,0.48,0.52,0.0
A17001,13,18,0,31,0.42,0.58,0.0
A17002,3,5,0,8,0.38,0.62,0.0
A17003,0,1,0,1,0.0,1.0,0.0
A17004,6,16,0,22,0.27,0.73,0.0
A17005,1,2,0,3,0.33,0.67,0.0
A17006,5,6,0,11,0.45,0.55,0.0
A17007,0,1,0,1,0.0,1.0,0.0
A17008,1,3,1,5,0.2,0.6,0.2
A17010,1,5,0,6,0.17,0.83,0.0
A17011,0,0,1,1,0.0,0.0,1.0
A17012,10,21,0,31,0.32,0.68,0.0
A17013,9,5,0,14,0.64,0.36,0.0
A17014,0,1,0,1,0.0,1.0,0.0
A17016,1,4,0,5,0.2,0.8,0.0
A17017,71,13,1,85,0.84,0.15,0.01
A17018,24,15,0,39,0.62,0.38,0.0
A17022,5,15,1,21,0.24,0.71,0.05
A17023,0,3,4,7,0.0,0.43,0.57
A17024,0,3,0,3,0.0,1.0,0.0
A17025,6,4,0,10,0.6,0.4,0.0
A17027,36,23,2,61,0.59,0.38,0.03
A17028,1,0,0,1,1.0,0.0,0.0
A17029,7,4,0,11,0.64,0.36,0.0
A17030,12,9,0,21,0.57,0.43,0.0
A17032,9,9,1,19,0.47,0.47,0.05
A17033,29,18,1,48,0.6,0.38,0.02
A17034,2,1,0,3,0.67,0.33,0.0
A17035,3,0,0,3,1.0,0.0,0.0
A17036,7,4,0,11,0.64,0.36,0.0
A17038,0,0,1,1,0.0,0.0,1.0
A17039,0,3,0,3,0.0,1.0,0.0
A17040,5,17,0,22,0.23,0.77,0.0
A17041,0,1,0,1,0.0,1.0,0.0
A17042,14,11,0,25,0.56,0.44,0.0
A17043,19,6,5,30,0.63,0.2,0.17
A17044,9,8,0,17,0.53,0.47,0.0
A17045,13,10,0,23,0.57,0.43,0.0
A17046,10,5,5,20,0.5,0.25,0.25
A17047,23,21,0,44,0.52,0.48,0.0
A17048,13,17,0,30,0.43,0.57,0.0
A17050,1,0,2,3,0.33,0.0,0.67
A17051,164,134,1,299,0.55,0.45,0.0
A17052,0,3,0,3,0.0,1.0,0.0
A17053,9,16,0,25,0.36,0.64,0.0
A17054,1,2,0,3,0.33,0.67,0.0
A17055,5,8,0,13,0.38,0.62,0.0
A17057,26,23,0,49,0.53,0.47,0.0
A17058,1,18,0,19,0.05,0.95,0.0
A17059,8,5,0,13,0.62,0.38,0.0
A17060,1,2,8,11,0.09,0.18,0.73
A17061,2,1,0,3,0.67,0.33,0.0
A17062,2,4,1,7,0.29,0.57,0.14
A17063,5,13,0,18,0.28,0.72,0.0
A17064,21,16,0,37,0.57,0.43,0.0
A17065,7,7,0,14,0.5,0.5,0.0
A17066,0,3,0,3,0.0,1.0,0.0
A17068,3,14,1,18,0.17,0.78,0.06
A17069,0,2,0,2,0.0,1.0,0.0
A17071,0,1,0,1,0.0,1.0,0.0
A17073,0,0,1,1,0.0,0.0,1.0
A17074,45,52,0,97,0.46,0.54,0.0
A17075,2,10,0,12,0.17,0.83,0.0
A17076,1,1,0,2,0.5,0.5,0.0
A17077,1,1,0,2,0.5,0.5,0.0
A17078,1,2,0,3,0.33,0.67,0.0
A17079,9,14,0,23,0.39,0.61,0.0
A17080,1,4,0,5,0.2,0.8,0.0
A17081,4,3,4,11,0.36,0.27,0.36
A17083,22,34,1,57,0.39,0.6,0.02
A17084,2,1,0,3,0.67,0.33,0.0
A17085,7,26,0,33,0.21,0.79,0.0
A17086,44,18,0,62,0.71,0.29,0.0
A17087,8,5,0,13,0.62,0.38,0.0
A17088,6,3,0,9,0.67,0.33,0.0
A17089,11,15,0,26,0.42,0.58,0.0
A17090,1,4,0,5,0.2,0.8,0.0
A17091,17,17,4,38,0.45,0.45,0.11
A17092,6,4,0,10,0.6,0.4,0.0
A17093,9,7,0,16,0.56,0.44,0.0
A17094,6,7,0,13,0.46,0.54,0.0
A17095,8,12,0,20,0.4,0.6,0.0
A17096,6,13,2,21,0.29,0.62,0.1
A17097,9,4,0,13,0.69,0.31,0.0
A17098,12,3,0,15,0.8,0.2,0.0
A17099,14,32,0,46,0.3,0.7,0.0
A17101,7,13,0,20,0.35,0.65,0.0
A17103,0,1,0,1,0.0,1.0,0.0
A17104,101,104,6,211,0.48,0.49,0.03
A17105,83,35,8,126,0.66,0.28,0.06
A17106,5,5,14,24,0.21,0.21,0.58
A17107,6,8,1,15,0.4,0.53,0.07
A17108,25,23,1,49,0.51,0.47,0.02
A17109,103,58,3,164,0.63,0.35,0.02
A17110,3,14,0,17,0.18,0.82,0.0
A17112,6,6,0,12,0.5,0.5,0.0
A17113,56,53,0,109,0.51,0.49,0.0
A17114,13,20,2,35,0.37,0.57,0.06
A17116,8,5,0,13,0.62,0.38,0.0
A17117,1,6,0,7,0.14,0.86,0.0
A17118,31,23,0,54,0.57,0.43,0.0
A17119,9,18,1,28,0.32,0.64,0.04
A17120,1,5,0,6,0.17,0.83,0.0
A17121,48,39,2,89,0.54,0.44,0.02
A17122,3,12,1,16,0.19,0.75,0.06
A17123,4,9,0,13,0.31,0.69,0.0
A17124,24,16,0,40,0.6,0.4,0.0
A17125,7,12,0,19,0.37,0.63,0.0
A17126,0,4,0,4,0.0,1.0,0.0
A17127,30,30,1,61,0.49,0.49,0.02
A17128,18,11,1,30,0.6,0.37,0.03
A17129,56,22,1,79,0.71,0.28,0.01
A17131,81,32,2,115,0.7,0.28,0.02
A17132,25,19,0,44,0.57,0.43,0.0
A17133,1,9,0,10,0.1,0.9,0.0
A17134,15,17,0,32,0.47,0.53,0.0
A17135,15,10,0,25,0.6,0.4,0.0
A17136,2,0,0,2,1.0,0.0,0.0
A17137,18,39,0,57,0.32,0.68,0.0
A17139,2,0,0,2,1.0,0.0,0.0
A17140,1,1,0,2,0.5,0.5,0.0
A17141,5,3,0,8,0.62,0.38,0.0
A17142,7,24,0,31,0.23,0.77,0.0
A17143,21,6,26,53,0.4,0.11,0.49
A17144,8,12,9,29,0.28,0.41,0.31
A17145,78,167,32,277,0.28,0.6,0.12
A17146,28,19,10,57,0.49,0.33,0.18
A17147,120,36,3,159,0.75,0.23,0.02
A17148,1,2,0,3,0.33,0.67,0.0
A17149,4,7,0,11,0.36,0.64,0.0
A17150,59,38,4,101,0.58,0.38,0.04
A17151,29,19,1,49,0.59,0.39,0.02
A17153,9,22,0,31,0.29,0.71,0.0
A17154,0,1,0,1,0.0,1.0,0.0
A17155,9,17,1,27,0.33,0.63,0.04
A17157,0,12,0,12,0.0,1.0,0.0
A17158,10,3,0,13,0.77,0.23,0.0
A17159,8,10,0,18,0.44,0.56,0.0
A17160,0,8,0,8,0.0,1.0,0.0
A17161,24,28,0,52,0.46,0.54,0.0
A17162,21,22,5,48,0.44,0.46,0.1
A17164,5,14,0,19,0.26,0.74,0.0
A17165,2,1,1,4,0.5,0.25,0.25
A17166,118,47,0,165,0.72,0.28,0.0
A17167,15,10,2,27,0.56,0.37,0.07
A17168,11,2,0,13,0.85,0.15,0.0
A17170,6,1,0,7,0.86,0.14,0.0
A17171,33,33,0,66,0.5,0.5,0.0
A17172,1,1,0,2,0.5,0.5,0.0
A17173,4,6,0,10,0.4,0.6,0.0
A17174,6,5,0,11,0.55,0.45,0.0
A17175,6,7,0,13,0.46,0.54,0.0
A17176,1,1,0,2,0.5,0.5,0.0
A17177,2,13,0,15,0.13,0.87,0.0
A17178,11,4,0,15,0.73,0.27,0.0
A17179,78,94,0,172,0.45,0.55,0.0
A17180,0,6,0,6,0.0,1.0,0.0
A17181,10,1,0,11,0.91,0.09,0.0
A17182,0,1,0,1,0.0,1.0,0.0
A17183,2,5,0,7,0.29,0.71,0.0
A17184,1,3,0,4,0.25,0.75,0.0
A17185,4,6,0,10,0.4,0.6,0.0
A17186,39,34,0,73,0.53,0.47,0.0
A17188,5,18,0,23,0.22,0.78,0.0
A17190,3,7,0,10,0.3,0.7,0.0
A17191,12,6,0,18,0.67,0.33,0.0
A17192,42,21,0,63,0.67,0.33,0.0
A17193,46,25,0,71,0.65,0.35,0.0
A17194,43,21,0,64,0.67,0.33,0.0
A17195,11,11,1,23,0.48,0.48,0.04
A17196,6,6,0,12,0.5,0.5,0.0
A17197,0,4,0,4,0.0,1.0,0.0
A17198,1,0,0,1,1.0,0.0,0.0
A17200,0,5,0,5,0.0,1.0,0.0
A17201,2,1,0,3,0.67,0.33,0.0
A17202,0,2,0,2,0.0,1.0,0.0
A17203,7,4,0,11,0.64,0.36,0.0
A17204,2,12,0,14,0.14,0.86,0.0
A17206,24,18,0,42,0.57,0.43,0.0
A17207,0,3,0,3,0.0,1.0,0.0
A17208,41,19,0,60,0.68,0.32,0.0
A17209,4,5,0,9,0.44,0.56,0.0
A17210,89,31,0,120,0.74,0.26,0.0
A17212,4,2,1,7,0.57,0.29,0.14
A17213,1,1,0,2,0.5,0.5,0.0
A17214,3,4,3,10,0.3,0.4,0.3
A17215,2,4,0,6,0.33,0.67,0.0
A17216,9,1,0,10,0.9,0.1,0.0
A17217,1,1,0,2,0.5,0.5,0.0
A17218,0,6,0,6,0.0,1.0,0.0
A17219,10,11,0,21,0.48,0.52,0.0
A17220,17,49,0,66,0.26,0.74,0.0
A17221,7,6,0,13,0.54,0.46,0.0
A17223,1,1,0,2,0.5,0.5,0.0
A17224,1,0,0,1,1.0,0.0,0.0
A17226,25,10,0,35,0.71,0.29,0.0
A17228,1,9,0,10,0.1,0.9,0.0
A17229,5,10,0,15,0.33,0.67,0.0
A17230,7,7,3,17,0.41,0.41,0.18
A17231,0,1,1,2,0.0,0.5,0.5
A17232,1,9,2,12,0.08,0.75,0.17
A17233,18,10,0,28,0.64,0.36,0.0
A17235,0,2,4,6,0.0,0.33,0.67
A17236,16,10,0,26,0.62,0.38,0.0
A17238,0,1,0,1,0.0,1.0,0.0
A17239,2,8,1,11,0.18,0.73,0.09
A17241,14,32,0,46,0.3,0.7,0.0
A17242,3,2,0,5,0.6,0.4,0.0
A17244,5,5,0,10,0.5,0.5,0.0
A17245,12,36,0,48,0.25,0.75,0.0
A17246,2,10,0,12,0.17,0.83,0.0
A17247,5,4,1,10,0.5,0.4,0.1
A17248,18,8,0,26,0.69,0.31,0.0
A17250,14,20,0,34,0.41,0.59,0.0
A17251,2,4,0,6,0.33,0.67,0.0
A17252,1,5,0,6,0.17,0.83,0.0
A17253,1,2,0,3,0.33,0.67,0.0
A17254,3,0,0,3,1.0,0.0,0.0
A17255,0,2,0,2,0.0,1.0,0.0
A17256,1,0,0,1,1.0,0.0,0.0
A17260,2,4,0,6,0.33,0.67,0.0
A17261,5,7,0,12,0.42,0.58,0.0
A17263,0,1,0,1,0.0,1.0,0.0
A17264,4,9,1,14,0.29,0.64,0.07
A17267,4,3,0,7,0.57,0.43,0.0
A17268,0,1,0,1,0.0,1.0,0.0
A17269,2,3,0,5,0.4,0.6,0.0
A17270,3,1,0,4,0.75,0.25,0.0
A17271,0,2,1,3,0.0,0.67,0.33
A17272,2,4,0,6,0.33,0.67,0.0
A17274,4,11,0,15,0.27,0.73,0.0
A17276,4,7,0,11,0.36,0.64,0.0
A17277,2,0,0,2,1.0,0.0,0.0
A17278,9,11,0,20,0.45,0.55,0.0
A17279,0,2,0,2,0.0,1.0,0.0
A17280,7,8,2,17,0.41,0.47,0.12
A17281,13,8,0,21,0.62,0.38,0.0
A17284,24,18,1,43,0.56,0.42,0.02
A17285,4,7,0,11,0.36,0.64,0.0
A17286,8,3,0,11,0.73,0.27,0.0
A17290,34,8,0,42,0.81,0.19,0.0
A17291,15,14,0,29,0.52,0.48,0.0
A17292,6,2,0,8,0.75,0.25,0.0
A17293,13,4,0,17,0.76,0.24,0.0
A17294,2,11,0,13,0.15,0.85,0.0
A17295,1,6,0,7,0.14,0.86,0.0
A17296,11,5,0,16,0.69,0.31,0.0
A17297,8,3,0,11,0.73,0.27,0.0
A17298,7,8,0,15,0.47,0.53,0.0
A17299,14,4,0,18,0.78,0.22,0.0
A17300,18,20,4,42,0.43,0.48,0.1
A17301,60,38,3,101,0.59,0.38,0.03
A17302,14,19,0,33,0.42,0.58,0.0
A17303,3,2,0,5,0.6,0.4,0.0
A17304,36,14,1,51,0.71,0.27,0.02
A17305,12,11,0,23,0.52,0.48,0.0
A17306,23,17,0,40,0.57,0.42,0.0
A17307,2,2,0,4,0.5,0.5,0.0
A17308,1,2,0,3,0.33,0.67,0.0
A17309,16,6,0,22,0.73,0.27,0.0
A17310,42,17,3,62,0.68,0.27,0.05
A17311,13,2,5,20,0.65,0.1,0.25
A17312,4,0,0,4,1.0,0.0,0.0
A17313,1,3,0,4,0.25,0.75,0.0
A17314,5,3,0,8,0.62,0.38,0.0
A17315,29,4,0,33,0.88,0.12,0.0
A17317,1,11,0,12,0.08,0.92,0.0
A17318,0,2,0,2,0.0,1.0,0.0
A17320,1,0,1,2,0.5,0.0,0.5
A17321,0,3,0,3,0.0,1.0,0.0
A17322,10,56,0,66,0.15,0.85,0.0
A17323,5,0,0,5,1.0,0.0,0.0
A17324,3,4,0,7,0.43,0.57,0.0
A17325,0,5,0,5,0.0,1.0,0.0
A17327,0,1,0,1,0.0,1.0,0.0
A17329,6,10,0,16,0.38,0.62,0.0
A17333,3,12,0,15,0.2,0.8,0.0
A17334,0,3,0,3,0.0,1.0,0.0
A17335,5,2,0,7,0.71,0.29,0.0
A17336,2,1,0,3,0.67,0.33,0.0
A17337,1,2,0,3,0.33,0.67,0.0
A17338,2,0,0,2,1.0,0.0,0.0
A17339,3,0,0,3,1.0,0.0,0.0
A17342,13,4,0,17,0.76,0.24,0.0
A17343,9,4,0,13,0.69,0.31,0.0
A17344,27,5,0,32,0.84,0.16,0.0
A17345,4,0,0,4,1.0,0.0,0.0
A17346,0,3,0,3,0.0,1.0,0.0
A17347,22,58,0,80,0.28,0.72,0.0
A17348,5,13,0,18,0.28,0.72,0.0
A17349,2,0,0,2,1.0,0.0,0.0
A17350,11,7,0,18,0.61,0.39,0.0
A17351,1,2,0,3,0.33,0.67,0.0
A17352,14,25,0,39,0.36,0.64,0.0
A17353,3,9,0,12,0.25,0.75,0.0
A17354,25,11,22,58,0.43,0.19,0.38
A17355,0,1,0,1,0.0,1.0,0.0
A17356,3,4,0,7,0.43,0.57,0.0
A17357,1,0,0,1,1.0,0.0,0.0
A17358,24,22,3,49,0.49,0.45,0.06
A17359,1,0,0,1,1.0,0.0,0.0
A17360,18,6,1,25,0.72,0.24,0.04
A17361,50,27,6,83,0.6,0.33,0.07
A17362,2,0,0,2,1.0,0.0,0.0
A17363,4,0,0,4,1.0,0.0,0.0
A17364,3,11,0,14,0.21,0.79,0.0
A17365,10,4,0,14,0.71,0.29,0.0
A17366,6,11,0,17,0.35,0.65,0.0
A17368,0,3,0,3,0.0,1.0,0.0
A17370,8,9,2,19,0.42,0.47,0.11
A17372,0,5,0,5,0.0,1.0,0.0
A17373,1,2,0,3,0.33,0.67,0.0
A17374,4,4,0,8,0.5,0.5,0.0
A17375,0,3,0,3,0.0,1.0,0.0
A17376,1,6,0,7,0.14,0.86,0.0
A17378,20,8,0,28,0.71,0.29,0.0
A17379,1,8,0,9,0.11,0.89,0.0
A17380,9,14,1,24,0.38,0.58,0.04
A17381,7,8,0,15,0.47,0.53,0.0
A17382,1,20,0,21,0.05,0.95,0.0
A17383,1,1,0,2,0.5,0.5,0.0
A17384,2,3,3,8,0.25,0.38,0.38
A17385,2,6,0,8,0.25,0.75,0.0
A17386,0,47,0,47,0.0,1.0,0.0
A17387,1,9,2,12,0.08,0.75,0.17
A17388,1,0,0,1,1.0,0.0,0.0
A17390,1,0,0,1,1.0,0.0,0.0
A17392,2,5,0,7,0.29,0.71,0.0
A17394,1,0,0,1,1.0,0.0,0.0
A17395,1,2,4,7,0.14,0.29,0.57
A17396,5,14,0,19,0.26,0.74,0.0
A17397,7,5,2,14,0.5,0.36,0.14
A17398,214,211,15,440,0.49,0.48,0.03
A17399,37,23,1,61,0.61,0.38,0.02
A17400,9,8,8,25,0.36,0.32,0.32
A17401,4,2,0,6,0.67,0.33,0.0
A17402,1,3,0,4,0.25,0.75,0.0
A17403,11,12,0,23,0.48,0.52,0.0
A17404,5,1,0,6,0.83,0.17,0.0
A17405,3,11,0,14,0.21,0.79,0.0
A17406,4,1,3,8,0.5,0.12,0.38
A17408,7,4,0,11,0.64,0.36,0.0
A17409,2,0,0,2,1.0,0.0,0.0
A17410,5,2,9,16,0.31,0.12,0.56
A17411,3,2,0,5,0.6,0.4,0.0
A17414,268,122,5,395,0.68,0.31,0.01
A17415,0,2,0,2,0.0,1.0,0.0
A17417,0,7,0,7,0.0,1.0,0.0
A17418,2,5,0,7,0.29,0.71,0.0
A17422,0,15,0,15,0.0,1.0,0.0
A17423,3,9,0,12,0.25,0.75,0.0
A17424,1,3,0,4,0.25,0.75,0.0
A17425,36,37,0,73,0.49,0.51,0.0
A17426,1,4,0,5,0.2,0.8,0.0
A17427,3,4,2,9,0.33,0.44,0.22
A17428,0,4,0,4,0.0,1.0,0.0
A17429,2,2,0,4,0.5,0.5,0.0
A17430,178,150,11,339,0.53,0.44,0.03
A17433,6,6,2,14,0.43,0.43,0.14
A17434,12,24,0,36,0.33,0.67,0.0
A17435,1,2,1,4,0.25,0.5,0.25
A17436,3,3,0,6,0.5,0.5,0.0
A17437,0,3,0,3,0.0,1.0,0.0
A17438,4,0,0,4,1.0,0.0,0.0
A17441,5,10,0,15,0.33,0.67,0.0
A17444,1,4,0,5,0.2,0.8,0.0
A17445,2,12,0,14,0.14,0.86,0.0
A17446,1,5,0,6,0.17,0.83,0.0
A17447,1,12,0,13,0.08,0.92,0.0
A17448,0,2,0,2,0.0,1.0,0.0
A17450,0,5,1,6,0.0,0.83,0.17
A17451,5,0,0,5,1.0,0.0,0.0
A17452,1,3,0,4,0.25,0.75,0.0
A17453,6,4,1,11,0.55,0.36,0.09
A17454,22,11,1,34,0.65,0.32,0.03
A17457,1,2,0,3,0.33,0.67,0.0
A17458,14,9,5,28,0.5,0.32,0.18
A17460,3,3,1,7,0.43,0.43,0.14
A17461,1,2,0,3,0.33,0.67,0.0
A17462,19,30,0,49,0.39,0.61,0.0
A17463,0,3,0,3,0.0,1.0,0.0
A17464,5,15,0,20,0.25,0.75,0.0
A17465,2,2,0,4,0.5,0.5,0.0
A17466,2,4,1,7,0.29,0.57,0.14
A17467,5,2,5,12,0.42,0.17,0.42
A17468,3,6,0,9,0.33,0.67,0.0
A17469,3,14,0,17,0.18,0.82,0.0
A17470,9,8,8,25,0.36,0.32,0.32
A17471,1,1,0,2,0.5,0.5,0.0
A17472,2,2,1,5,0.4,0.4,0.2
A17473,3,5,0,8,0.38,0.62,0.0
A17474,9,2,0,11,0.82,0.18,0.0
A17475,0,2,0,2,0.0,1.0,0.0
A17478,2,20,0,22,0.09,0.91,0.0
A17480,1,3,2,6,0.17,0.5,0.33
A17481,1,2,0,3,0.33,0.67,0.0
A17482,0,5,0,5,0.0,1.0,0.0
A17483,0,1,0,1,0.0,1.0,0.0
A17484,7,5,0,12,0.58,0.42,0.0
A17485,3,3,0,6,0.5,0.5,0.0
A17486,3,8,0,11,0.27,0.73,0.0
A17487,1,1,0,2,0.5,0.5,0.0
A17488,20,5,1,26,0.77,0.19,0.04
A17489,4,4,0,8,0.5,0.5,0.0
A17490,12,11,2,25,0.48,0.44,0.08
A17492,3,17,2,22,0.14,0.77,0.09
A17493,1,0,0,1,1.0,0.0,0.0
A17495,0,0,1,1,0.0,0.0,1.0
A17496,0,0,2,2,0.0,0.0,1.0
A17497,3,14,0,17,0.18,0.82,0.0
A17498,5,2,1,8,0.62,0.25,0.12
A17499,0,0,3,3,0.0,0.0,1.0
A17500,6,5,0,11,0.55,0.45,0.0
A17501,41,21,1,63,0.65,0.33,0.02
A17502,2,1,0,3,0.67,0.33,0.0
A17503,2,11,0,13,0.15,0.85,0.0
A17504,15,9,2,26,0.58,0.35,0.08
A17505,1,5,0,6,0.17,0.83,0.0
A17507,0,1,1,2,0.0,0.5,0.5
A17508,2,0,4,6,0.33,0.0,0.67
A17509,6,14,1,21,0.29,0.67,0.05
A17510,4,10,0,14,0.29,0.71,0.0
A17511,10,10,0,20,0.5,0.5,0.0
A17513,40,29,1,70,0.57,0.41,0.01
A17514,6,17,9,32,0.19,0.53,0.28
A17515,1,1,0,2,0.5,0.5,0.0
A17518,20,11,0,31,0.65,0.35,0.0
A17519,1,4,0,5,0.2,0.8,0.0
A17521,0,2,0,2,0.0,1.0,0.0
A17523,0,2,0,2,0.0,1.0,0.0
A17524,19,7,0,26,0.73,0.27,0.0
A17525,0,2,0,2,0.0,1.0,0.0
A17526,85,4,1,90,0.94,0.04,0.01
A17527,0,1,0,1,0.0,1.0,0.0
A17529,10,10,0,20,0.5,0.5,0.0
A17530,1,1,0,2,0.5,0.5,0.0
A17531,25,33,2,60,0.42,0.55,0.03
A17532,3,4,0,7,0.43,0.57,0.0
A17533,5,3,0,8,0.62,0.38,0.0
A17535,2,5,0,7,0.29,0.71,0.0
A17536,8,9,5,22,0.36,0.41,0.23
A17537,1,1,1,3,0.33,0.33,0.33
A17538,0,2,1,3,0.0,0.67,0.33
A17539,0,1,0,1,0.0,1.0,0.0
A17540,0,4,0,4,0.0,1.0,0.0
A17541,0,0,1,1,0.0,0.0,1.0
A17543,0,1,0,1,0.0,1.0,0.0
A17544,0,3,0,3,0.0,1.0,0.0
A17545,0,0,3,3,0.0,0.0,1.0
A17546,1,0,0,1,1.0,0.0,0.0
A17547,0,0,1,1,0.0,0.0,1.0
A17548,0,1,1,2,0.0,0.5,0.5
A17549,1,2,0,3,0.33,0.67,0.0
A17550,1,3,0,4,0.25,0.75,0.0
A17551,0,0,1,1,0.0,0.0,1.0
A17552,1,3,0,4,0.25,0.75,0.0
A17553,0,9,0,9,0.0,1.0,0.0
A17556,1,2,0,3,0.33,0.67,0.0
A17557,1,5,0,6,0.17,0.83,0.0
A17558,2,0,0,2,1.0,0.0,0.0
A17560,10,16,1,27,0.37,0.59,0.04
A17561,3,14,0,17,0.18,0.82,0.0
A17563,1,2,0,3,0.33,0.67,0.0
A17564,3,4,0,7,0.43,0.57,0.0
A17566,14,10,0,24,0.58,0.42,0.0
A17567,0,1,0,1,0.0,1.0,0.0
A17568,5,1,0,6,0.83,0.17,0.0
A17569,1,0,0,1,1.0,0.0,0.0
A17570,6,14,1,21,0.29,0.67,0.05
A17573,0,0,2,2,0.0,0.0,1.0
A17574,20,8,0,28,0.71,0.29,0.0
A17575,1,3,0,4,0.25,0.75,0.0
A17577,3,23,0,26,0.12,0.88,0.0
A17578,0,13,0,13,0.0,1.0,0.0
A17579,0,13,0,13,0.0,1.0,0.0
A17580,15,5,4,24,0.62,0.21,0.17
A17583,0,2,0,2,0.0,1.0,0.0
A17584,4,3,0,7,0.57,0.43,0.0
A17585,9,13,0,22,0.41,0.59,0.0
A17586,0,1,0,1,0.0,1.0,0.0
A17587,44,14,1,59,0.75,0.24,0.02
A17588,11,2,0,13,0.85,0.15,0.0
A17589,0,1,0,1,0.0,1.0,0.0
A17590,0,1,0,1,0.0,1.0,0.0
A17592,0,1,0,1,0.0,1.0,0.0
A17593,4,8,3,15,0.27,0.53,0.2
A17594,5,3,0,8,0.62,0.38,0.0
A17595,3,18,0,21,0.14,0.86,0.0
A17596,0,4,0,4,0.0,1.0,0.0
A17597,1,1,0,2,0.5,0.5,0.0
A17598,38,15,0,53,0.72,0.28,0.0
A17599,4,8,0,12,0.33,0.67,0.0
A17600,9,10,2,21,0.43,0.48,0.1
A17601,11,2,0,13,0.85,0.15,0.0
A17602,3,7,1,11,0.27,0.64,0.09
A17603,6,11,0,17,0.35,0.65,0.0
A17604,2,1,0,3,0.67,0.33,0.0
A17605,0,1,0,1,0.0,1.0,0.0
A17606,1,1,1,3,0.33,0.33,0.33
A17607,6,7,0,13,0.46,0.54,0.0
A17608,7,8,1,16,0.44,0.5,0.06
A17610,10,26,1,37,0.27,0.7,0.03
A17612,1,2,0,3,0.33,0.67,0.0
A17613,1,0,1,2,0.5,0.0,0.5
A17614,4,0,0,4,1.0,0.0,0.0
A17615,8,16,8,32,0.25,0.5,0.25
A17616,3,9,0,12,0.25,0.75,0.0
A17617,45,27,0,72,0.62,0.38,0.0
A17618,6,3,0,9,0.67,0.33,0.0
A17619,8,2,2,12,0.67,0.17,0.17
A17621,2,4,0,6,0.33,0.67,0.0
A17622,0,1,0,1,0.0,1.0,0.0
A17623,18,8,9,35,0.51,0.23,0.26
A17624,3,5,0,8,0.38,0.62,0.0
A17625,8,15,4,27,0.3,0.56,0.15
A17626,5,7,0,12,0.42,0.58,0.0
A17627,2,7,0,9,0.22,0.78,0.0
A17628,0,1,0,1,0.0,1.0,0.0
A17629,13,8,1,22,0.59,0.36,0.05
A17631,1,5,0,6,0.17,0.83,0.0
A17632,3,10,0,13,0.23,0.77,0.0
A17633,9,13,0,22,0.41,0.59,0.0
A17634,9,6,0,15,0.6,0.4,0.0
A17635,5,5,0,10,0.5,0.5,0.0
A17636,0,11,0,11,0.0,1.0,0.0
A17637,9,8,0,17,0.53,0.47,0.0
A17638,3,1,1,5,0.6,0.2,0.2
A17639,6,3,0,9,0.67,0.33,0.0
A17640,0,1,1,2,0.0,0.5,0.5
A17641,3,12,0,15,0.2,0.8,0.0
A17642,0,6,0,6,0.0,1.0,0.0
A17643,2,11,0,13,0.15,0.85,0.0
A17645,0,2,1,3,0.0,0.67,0.33
A17646,23,69,0,92,0.25,0.75,0.0
A17647,109,9,2,120,0.91,0.07,0.02
A17648,0,3,0,3,0.0,1.0,0.0
A17649,0,3,0,3,0.0,1.0,0.0
A17650,6,4,2,12,0.5,0.33,0.17
A17651,2,0,0,2,1.0,0.0,0.0
A17652,16,12,0,28,0.57,0.43,0.0
A17653,3,0,1,4,0.75,0.0,0.25
A17654,2,17,0,19,0.11,0.89,0.0
A17655,3,5,0,8,0.38,0.62,0.0
A17656,2,2,1,5,0.4,0.4,0.2
A17657,12,12,0,24,0.5,0.5,0.0
A17658,12,20,0,32,0.38,0.62,0.0
A17659,2,5,0,7,0.29,0.71,0.0
A17660,10,4,3,17,0.59,0.24,0.18
A17661,335,340,14,689,0.49,0.49,0.02
A17662,16,8,0,24,0.67,0.33,0.0
A17663,8,16,1,25,0.32,0.64,0.04
A17664,3,7,0,10,0.3,0.7,0.0
A17666,37,39,0,76,0.49,0.51,0.0
A17667,6,5,0,11,0.55,0.45,0.0
A17668,12,7,0,19,0.63,0.37,0.0
A17669,2,5,1,8,0.25,0.62,0.12
A17670,8,5,5,18,0.44,0.28,0.28
A17672,1,3,0,4,0.25,0.75,0.0
A17673,1,5,0,6,0.17,0.83,0.0
A17674,0,2,0,2,0.0,1.0,0.0
A17675,335,61,0,396,0.85,0.15,0.0
A17676,5,5,2,12,0.42,0.42,0.17
A17677,3,0,0,3,1.0,0.0,0.0
A17678,5,7,0,12,0.42,0.58,0.0
A17679,5,6,0,11,0.45,0.55,0.0
A17680,4,4,28,36,0.11,0.11,0.78
A17681,0,2,1,3,0.0,0.67,0.33
A17682,2,6,0,8,0.25,0.75,0.0
A17683,5,1,0,6,0.83,0.17,0.0
A17684,1,2,0,3,0.33,0.67,0.0
A17685,4,5,5,14,0.29,0.36,0.36
A17686,2,5,0,7,0.29,0.71,0.0
A17687,1,3,0,4,0.25,0.75,0.0
A17688,3,10,0,13,0.23,0.77,0.0
A17689,1,11,0,12,0.08,0.92,0.0
A17690,16,17,0,33,0.48,0.52,0.0
A17691,1,2,0,3,0.33,0.67,0.0
A17692,10,10,1,21,0.48,0.48,0.05
A17693,3,4,0,7,0.43,0.57,0.0
A17694,0,1,0,1,0.0,1.0,0.0
A17695,5,6,0,11,0.45,0.55,0.0
A17696,0,1,0,1,0.0,1.0,0.0
A17697,10,9,0,19,0.53,0.47,0.0
A17698,5,9,0,14,0.36,0.64,0.0
A17699,56,80,1,137,0.41,0.58,0.01
A17700,2,4,0,6,0.33,0.67,0.0
A17702,1,2,0,3,0.33,0.67,0.0
A17703,233,47,0,280,0.83,0.17,0.0
A17704,20,17,0,37,0.54,0.46,0.0
A17705,4,2,0,6,0.67,0.33,0.0
A17707,0,3,1,4,0.0,0.75,0.25
A17708,12,11,1,24,0.5,0.46,0.04
A17709,0,2,0,2,0.0,1.0,0.0
A17710,2,0,1,3,0.67,0.0,0.33
A17711,5,3,1,9,0.56,0.33,0.11
A17712,3,3,0,6,0.5,0.5,0.0
A17713,1,6,0,7,0.14,0.86,0.0
A17714,1,2,0,3,0.33,0.67,0.0
A17715,0,5,0,5,0.0,1.0,0.0
A17716,9,29,0,38,0.24,0.76,0.0
A17717,3,5,0,8,0.38,0.62,0.0
A17718,1,3,0,4,0.25,0.75,0.0
A17719,13,12,0,25,0.52,0.48,0.0
A17720,0,1,0,1,0.0,1.0,0.0
A17721,5,9,0,14,0.36,0.64,0.0
A17722,0,2,0,2,0.0,1.0,0.0
A17723,7,29,2,38,0.18,0.76,0.05
A17724,1,5,0,6,0.17,0.83,0.0
A17726,4,8,0,12,0.33,0.67,0.0
A17727,7,9,0,16,0.44,0.56,0.0
A17728,0,2,0,2,0.0,1.0,0.0
A17729,13,4,0,17,0.76,0.24,0.0
A17730,0,4,0,4,0.0,1.0,0.0
A17731,5,106,0,111,0.05,0.95,0.0
A17732,6,4,1,11,0.55,0.36,0.09
A17734,17,13,0,30,0.57,0.43,0.0
A17735,27,10,8,45,0.6,0.22,0.18
A17736,4,14,0,18,0.22,0.78,0.0
A17737,0,3,0,3,0.0,1.0,0.0
A17738,26,26,1,53,0.49,0.49,0.02
A17740,3,2,0,5,0.6,0.4,0.0
A17742,2,10,0,12,0.17,0.83,0.0
A17745,5,2,0,7,0.71,0.29,0.0
A17746,6,10,0,16,0.38,0.62,0.0
A17748,1,11,0,12,0.08,0.92,0.0
A17750,0,3,0,3,0.0,1.0,0.0
A17751,0,1,0,1,0.0,1.0,0.0
A17752,3,12,0,15,0.2,0.8,0.0
A17753,5,2,0,7,0.71,0.29,0.0
A17754,1,5,1,7,0.14,0.71,0.14
A17755,9,9,0,18,0.5,0.5,0.0
A17756,1,1,0,2,0.5,0.5,0.0
A17757,4,4,0,8,0.5,0.5,0.0
A17758,1,5,0,6,0.17,0.83,0.0
A17759,2,0,0,2,1.0,0.0,0.0
A17760,17,18,0,35,0.49,0.51,0.0
A17761,6,3,1,10,0.6,0.3,0.1
A17762,0,3,0,3,0.0,1.0,0.0
A17764,13,4,1,18,0.72,0.22,0.06
A17765,13,25,0,38,0.34,0.66,0.0
A17766,3,1,3,7,0.43,0.14,0.43
A17767,13,18,0,31,0.42,0.58,0.0
A17769,0,1,0,1,0.0,1.0,0.0
A17770,0,3,0,3,0.0,1.0,0.0
A17771,1,18,0,19,0.05,0.95,0.0
A17772,1,4,0,5,0.2,0.8,0.0
A17773,27,66,0,93,0.29,0.71,0.0
A17774,7,5,0,12,0.58,0.42,0.0
A17775,69,140,5,214,0.32,0.65,0.02
A17776,23,34,0,57,0.4,0.6,0.0
A17777,9,11,0,20,0.45,0.55,0.0
A17779,344,98,1,443,0.78,0.22,0.0
A17780,8,10,1,19,0.42,0.53,0.05
A17781,4,4,0,8,0.5,0.5,0.0
A17782,1,0,5,6,0.17,0.0,0.83
A17783,5,3,0,8,0.62,0.38,0.0
A17784,4,6,2,12,0.33,0.5,0.17
A17785,49,31,14,94,0.52,0.33,0.15
A17786,12,16,1,29,0.41,0.55,0.03
A17787,0,2,0,2,0.0,1.0,0.0
A17788,1,1,0,2,0.5,0.5,0.0
A17789,1,1,0,2,0.5,0.5,0.0
A17790,1,0,0,1,1.0,0.0,0.0
A17791,3,7,0,10,0.3,0.7,0.0
A17792,7,9,0,16,0.44,0.56,0.0
A17793,16,19,6,41,0.39,0.46,0.15
A17794,9,19,0,28,0.32,0.68,0.0
A17795,17,12,0,29,0.59,0.41,0.0
A17796,1,0,2,3,0.33,0.0,0.67
A17799,0,4,0,4,0.0,1.0,0.0
A17800,0,5,5,10,0.0,0.5,0.5
A17803,0,3,0,3,0.0,1.0,0.0
A17804,1,18,0,19,0.05,0.95,0.0
A17806,1,0,0,1,1.0,0.0,0.0
A17807,0,1,0,1,0.0,1.0,0.0
A17808,1,0,0,1,1.0,0.0,0.0
A17809,3,7,1,11,0.27,0.64,0.09
A17810,16,7,0,23,0.7,0.3,0.0
A17811,2,3,0,5,0.4,0.6,0.0
A17812,0,3,0,3,0.0,1.0,0.0
A17813,1,9,0,10,0.1,0.9,0.0
A17815,0,13,0,13,0.0,1.0,0.0
A17816,0,4,0,4,0.0,1.0,0.0
A17817,28,6,0,34,0.82,0.18,0.0
A17818,11,1,0,12,0.92,0.08,0.0
A17820,0,2,0,2,0.0,1.0,0.0
A17821,24,14,30,68,0.35,0.21,0.44
A17823,8,15,0,23,0.35,0.65,0.0
A17824,2,2,0,4,0.5,0.5,0.0
A17825,9,20,5,34,0.26,0.59,0.15
A17827,4,4,0,8,0.5,0.5,0.0
A17828,0,1,0,1,0.0,1.0,0.0
A17829,9,15,0,24,0.38,0.62,0.0
A17831,5,5,0,10,0.5,0.5,0.0
A17832,12,24,0,36,0.33,0.67,0.0
A17833,10,7,0,17,0.59,0.41,0.0
A17835,0,1,0,1,0.0,1.0,0.0
A17836,0,5,0,5,0.0,1.0,0.0
A17838,0,4,0,4,0.0,1.0,0.0
A17841,2,1,1,4,0.5,0.25,0.25
A17843,0,1,0,1,0.0,1.0,0.0
A17844,8,10,1,19,0.42,0.53,0.05
A17846,3,9,3,15,0.2,0.6,0.2
A17847,20,13,0,33,0.61,0.39,0.0
A17848,7,7,0,14,0.5,0.5,0.0
A17849,1,9,0,10,0.1,0.9,0.0
A17853,3,5,2,10,0.3,0.5,0.2
A17854,0,2,0,2,0.0,1.0,0.0
A17855,6,5,0,11,0.55,0.45,0.0
A17858,0,2,2,4,0.0,0.5,0.5
A17859,1,5,0,6,0.17,0.83,0.0
A17862,3,8,0,11,0.27,0.73,0.0
A17863,2,4,0,6,0.33,0.67,0.0
A17864,0,1,0,1,0.0,1.0,0.0
A17865,1,2,0,3,0.33,0.67,0.0
A17866,1,11,0,12,0.08,0.92,0.0
A17867,3,10,0,13,0.23,0.77,0.0
A17868,0,4,0,4,0.0,1.0,0.0
A17875,5,11,8,24,0.21,0.46,0.33
A17876,2,7,1,10,0.2,0.7,0.1
A17878,1,9,0,10,0.1,0.9,0.0
A17879,9,21,0,30,0.3,0.7,0.0
A17880,0,2,0,2,0.0,1.0,0.0
A17881,11,15,0,26,0.42,0.58,0.0
A17882,0,1,0,1,0.0,1.0,0.0
A17883,2,1,0,3,0.67,0.33,0.0
A17884,1,14,0,15,0.07,0.93,0.0
A17886,0,1,1,2,0.0,0.5,0.5
A17888,2,8,1,11,0.18,0.73,0.09
A17889,3,5,0,8,0.38,0.62,0.0
A17890,5,7,0,12,0.42,0.58,0.0
A17891,3,2,0,5,0.6,0.4,0.0
A17892,22,36,0,58,0.38,0.62,0.0
A17893,1,13,0,14,0.07,0.93,0.0
A17894,3,3,16,22,0.14,0.14,0.73
A17895,1,0,0,1,1.0,0.0,0.0
A17896,130,124,2,256,0.51,0.48,0.01
A17897,12,12,0,24,0.5,0.5,0.0
A17898,0,1,0,1,0.0,1.0,0.0
A17899,13,4,0,17,0.76,0.24,0.0
A17900,4,6,0,10,0.4,0.6,0.0
A17901,2,2,0,4,0.5,0.5,0.0
A17903,0,2,0,2,0.0,1.0,0.0
A17904,3,10,0,13,0.23,0.77,0.0
A17906,3,6,0,9,0.33,0.67,0.0
A17907,3,14,0,17,0.18,0.82,0.0
A17910,2,10,0,12,0.17,0.83,0.0
A17911,3,6,0,9,0.33,0.67,0.0
A17912,0,1,0,1,0.0,1.0,0.0
A17913,79,55,8,142,0.56,0.39,0.06
A17914,1,0,2,3,0.33,0.0,0.67
A17917,1,0,0,1,1.0,0.0,0.0
A17919,1,0,0,1,1.0,0.0,0.0
A17921,5,23,2,30,0.17,0.77,0.07
A17922,2,3,0,5,0.4,0.6,0.0
A17923,0,2,0,2,0.0,1.0,0.0
A17925,1,3,11,15,0.07,0.2,0.73
A17926,7,4,1,12,0.58,0.33,0.08
A17929,0,6,0,6,0.0,1.0,0.0
A17930,0,4,0,4,0.0,1.0,0.0
A17931,5,14,0,19,0.26,0.74,0.0
A17932,1,24,0,25,0.04,0.96,0.0
A17933,2,7,0,9,0.22,0.78,0.0
A17934,3,8,0,11,0.27,0.73,0.0
A17935,0,5,0,5,0.0,1.0,0.0
A17937,0,1,0,1,0.0,1.0,0.0
A17939,3,4,1,8,0.38,0.5,0.12
A17941,0,1,0,1,0.0,1.0,0.0
A17942,0,3,0,3,0.0,1.0,0.0
A17943,2,5,0,7,0.29,0.71,0.0
A17944,1,12,0,13,0.08,0.92,0.0
A17945,10,3,0,13,0.77,0.23,0.0
A17946,10,5,0,15,0.67,0.33,0.0
A17947,0,1,0,1,0.0,1.0,0.0
A17948,0,2,0,2,0.0,1.0,0.0
A17949,10,17,3,30,0.33,0.57,0.1
A17951,5,20,1,26,0.19,0.77,0.04
A17952,3,6,0,9,0.33,0.67,0.0
A17953,0,1,0,1,0.0,1.0,0.0
A17954,0,12,0,12,0.0,1.0,0.0
A17955,2,4,0,6,0.33,0.67,0.0
A17956,3,10,8,21,0.14,0.48,0.38
A17957,4,18,0,22,0.18,0.82,0.0
A17958,1,3,2,6,0.17,0.5,0.33
A17959,3,7,2,12,0.25,0.58,0.17
A17960,0,2,0,2,0.0,1.0,0.0
A17961,5,5,0,10,0.5,0.5,0.0
A17962,4,6,0,10,0.4,0.6,0.0
A17963,5,9,4,18,0.28,0.5,0.22
A17964,4,4,0,8,0.5,0.5,0.0
A17966,9,15,0,24,0.38,0.62,0.0
A17967,142,155,3,300,0.47,0.52,0.01
A17968,3,1,0,4,0.75,0.25,0.0
A17969,0,2,0,2,0.0,1.0,0.0
A17970,1,9,0,10,0.1,0.9,0.0
A17971,7,28,0,35,0.2,0.8,0.0
A17972,5,9,0,14,0.36,0.64,0.0
A17973,15,19,1,35,0.43,0.54,0.03
A17974,64,146,2,212,0.3,0.69,0.01
A17975,3,9,1,13,0.23,0.69,0.08
A17976,2,6,0,8,0.25,0.75,0.0
A17977,7,9,0,16,0.44,0.56,0.0
A17978,1,6,0,7,0.14,0.86,0.0
A17979,0,1,0,1,0.0,1.0,0.0
A17980,1,2,0,3,0.33,0.67,0.0
A17981,0,3,0,3,0.0,1.0,0.0
A17982,4,6,0,10,0.4,0.6,0.0
A17984,7,6,0,13,0.54,0.46,0.0
A17985,2,4,0,6,0.33,0.67,0.0
A17986,186,173,1,360,0.52,0.48,0.0
A17988,0,1,0,1,0.0,1.0,0.0
A17989,1,5,0,6,0.17,0.83,0.0
A17990,1,0,0,1,1.0,0.0,0.0
A17991,24,20,0,44,0.55,0.45,0.0
A17992,5,11,0,16,0.31,0.69,0.0
A17994,2,11,0,13,0.15,0.85,0.0
A17996,7,6,0,13,0.54,0.46,0.0
A17998,0,4,0,4,0.0,1.0,0.0
A17999,3,1,0,4,0.75,0.25,0.0
A18000,3,4,0,7,0.43,0.57,0.0
A18001,4,22,0,26,0.15,0.85,0.0
A18002,11,17,0,28,0.39,0.61,0.0
A18003,5,18,0,23,0.22,0.78,0.0
A18006,0,4,0,4,0.0,1.0,0.0
A18008,2,3,0,5,0.4,0.6,0.0
A18009,3,5,0,8,0.38,0.62,0.0
A18010,14,6,0,20,0.7,0.3,0.0
A18011,0,1,0,1,0.0,1.0,0.0
A18013,0,3,0,3,0.0,1.0,0.0
A18015,1,5,0,6,0.17,0.83,0.0
A18016,3,9,0,12,0.25,0.75,0.0
A18017,12,16,0,28,0.43,0.57,0.0
A18018,1,2,0,3,0.33,0.67,0.0
A18019,4,7,0,11,0.36,0.64,0.0
A18020,5,11,0,16,0.31,0.69,0.0
A18021,12,17,0,29,0.41,0.59,0.0
A18022,7,24,0,31,0.23,0.77,0.0
A18023,1,1,0,2,0.5,0.5,0.0
A18024,1,1,0,2,0.5,0.5,0.0
A18025,8,8,0,16,0.5,0.5,0.0
A18026,19,17,14,50,0.38,0.34,0.28
A18027,4,5,0,9,0.44,0.56,0.0
A18028,2,5,0,7,0.29,0.71,0.0
A18029,8,17,0,25,0.32,0.68,0.0
A18030,19,14,1,34,0.56,0.41,0.03
A18031,2,4,0,6,0.33,0.67,0.0
A18032,11,19,0,30,0.37,0.63,0.0
A18033,11,17,0,28,0.39,0.61,0.0
A18034,0,2,0,2,0.0,1.0,0.0
A18035,0,2,0,2,0.0,1.0,0.0
A18036,0,2,0,2,0.0,1.0,0.0
A18037,2,2,0,4,0.5,0.5,0.0
A18038,4,8,0,12,0.33,0.67,0.0
A18039,3,2,1,6,0.5,0.33,0.17
A18041,6,16,0,22,0.27,0.73,0.0
A18042,1,5,0,6,0.17,0.83,0.0
A18043,0,2,0,2,0.0,1.0,0.0
A18044,7,10,0,17,0.41,0.59,0.0
A18045,0,4,0,4,0.0,1.0,0.0
A18047,0,1,0,1,0.0,1.0,0.0
A18048,2,10,0,12,0.17,0.83,0.0
A18051,0,1,0,1,0.0,1.0,0.0
A18052,1,0,0,1,1.0,0.0,0.0
A18053,2,0,0,2,1.0,0.0,0.0
A18054,6,22,0,28,0.21,0.79,0.0
A18055,5,1,2,8,0.62,0.12,0.25
A18056,5,6,0,11,0.45,0.55,0.0
A18057,8,11,2,21,0.38,0.52,0.1
A18058,0,30,0,30,0.0,1.0,0.0
A18059,0,1,0,1,0.0,1.0,0.0
A18061,11,8,0,19,0.58,0.42,0.0
A18062,1,3,1,5,0.2,0.6,0.2
A18063,41,12,0,53,0.77,0.23,0.0
A18064,7,5,0,12,0.58,0.42,0.0
A18066,2,6,0,8,0.25,0.75,0.0
A18067,43,22,0,65,0.66,0.34,0.0
A18068,0,5,0,5,0.0,1.0,0.0
A18072,2,4,1,7,0.29,0.57,0.14
A18073,7,5,0,12,0.58,0.42,0.0
A18074,0,1,0,1,0.0,1.0,0.0
A18075,5,2,0,7,0.71,0.29,0.0
A18076,5,19,1,25,0.2,0.76,0.04
A18077,1,1,0,2,0.5,0.5,0.0
A18078,8,4,0,12,0.67,0.33,0.0
A18079,8,27,0,35,0.23,0.77,0.0
A18080,0,1,0,1,0.0,1.0,0.0
A18083,33,54,0,87,0.38,0.62,0.0
A18085,2,4,0,6,0.33,0.67,0.0
A18086,1,33,0,34,0.03,0.97,0.0
A18087,9,9,0,18,0.5,0.5,0.0
A18088,2,2,0,4,0.5,0.5,0.0
A18089,0,4,0,4,0.0,1.0,0.0
A18090,0,2,0,2,0.0,1.0,0.0
A18093,4,5,1,10,0.4,0.5,0.1
A18094,2,41,0,43,0.05,0.95,0.0
A18095,4,12,0,16,0.25,0.75,0.0
A18096,2,2,0,4,0.5,0.5,0.0
A18097,1,4,0,5,0.2,0.8,0.0
A18098,5,26,0,31,0.16,0.84,0.0
A18099,3,4,0,7,0.43,0.57,0.0
A18100,2,3,0,5,0.4,0.6,0.0
A18101,1,5,0,6,0.17,0.83,0.0
A18102,5,14,0,19,0.26,0.74,0.0
A18103,5,10,0,15,0.33,0.67,0.0
A18104,1,8,0,9,0.11,0.89,0.0
A18105,0,1,0,1,0.0,1.0,0.0
A18106,0,1,0,1,0.0,1.0,0.0
A18107,0,1,0,1,0.0,1.0,0.0
A18108,1,2,0,3,0.33,0.67,0.0
A18109,7,8,0,15,0.47,0.53,0.0
A18111,0,1,0,1,0.0,1.0,0.0
A18115,101,18,0,119,0.85,0.15,0.0
A18116,33,9,0,42,0.79,0.21,0.0
A18117,0,2,0,2,0.0,1.0,0.0
A18118,8,5,0,13,0.62,0.38,0.0
A18119,95,61,0,156,0.61,0.39,0.0
A18120,0,1,1,2,0.0,0.5,0.5
A18121,0,3,0,3,0.0,1.0,0.0
A18122,60,48,0,108,0.56,0.44,0.0
A18123,6,4,0,10,0.6,0.4,0.0
A18124,4,4,0,8,0.5,0.5,0.0
A18125,0,1,0,1,0.0,1.0,0.0
A18126,20,16,0,36,0.56,0.44,0.0
A18127,0,2,0,2,0.0,1.0,0.0
A18128,2,9,0,11,0.18,0.82,0.0
A18129,26,28,0,54,0.48,0.52,0.0
A18131,53,45,1,99,0.54,0.45,0.01
A18135,14,8,0,22,0.64,0.36,0.0
A18136,0,2,0,2,0.0,1.0,0.0
A18137,111,43,0,154,0.72,0.28,0.0
A18138,0,1,0,1,0.0,1.0,0.0
A18139,14,12,0,26,0.54,0.46,0.0
A18140,2,6,0,8,0.25,0.75,0.0
A18141,0,1,0,1,0.0,1.0,0.0
A18142,53,14,0,67,0.79,0.21,0.0
A18143,3,7,0,10,0.3,0.7,0.0
A18144,28,14,0,42,0.67,0.33,0.0
A18145,2,5,0,7,0.29,0.71,0.0
A18147,113,49,0,162,0.7,0.3,0.0
A18148,30,9,0,39,0.77,0.23,0.0
A18149,2,3,0,5,0.4,0.6,0.0
A18150,109,58,0,167,0.65,0.35,0.0
A18151,0,1,0,1,0.0,1.0,0.0
A18153,130,119,1,250,0.52,0.48,0.0
A18154,6,9,0,15,0.4,0.6,0.0
A18155,7,5,0,12,0.58,0.42,0.0
A18156,9,5,6,20,0.45,0.25,0.3
A18157,2,5,1,8,0.25,0.62,0.12
A18158,0,7,0,7,0.0,1.0,0.0
A18159,10,20,0,30,0.33,0.67,0.0
A18162,6,4,0,10,0.6,0.4,0.0
A18163,126,119,0,245,0.51,0.49,0.0
A18164,39,7,3,49,0.8,0.14,0.06
A18165,0,1,0,1,0.0,1.0,0.0
A18166,93,62,0,155,0.6,0.4,0.0
A18167,1,30,0,31,0.03,0.97,0.0
A18168,2,3,0,5,0.4,0.6,0.0
A18169,0,1,0,1,0.0,1.0,0.0
A18170,44,46,0,90,0.49,0.51,0.0
A18171,7,6,0,13,0.54,0.46,0.0
A18172,6,3,0,9,0.67,0.33,0.0
A18173,1,14,0,15,0.07,0.93,0.0
A18174,3,4,0,7,0.43,0.57,0.0
A18176,2,0,0,2,1.0,0.0,0.0
A18177,3,2,0,5,0.6,0.4,0.0
A18178,3,7,0,10,0.3,0.7,0.0
A18180,0,2,0,2,0.0,1.0,0.0
A18183,126,130,0,256,0.49,0.51,0.0
A18184,0,1,0,1,0.0,1.0,0.0
A18185,1,0,0,1,1.0,0.0,0.0
A18187,2,3,0,5,0.4,0.6,0.0
A18188,0,3,0,3,0.0,1.0,0.0
A18190,64,46,0,110,0.58,0.42,0.0
A18191,5,2,0,7,0.71,0.29,0.0
A18192,3,5,0,8,0.38,0.62,0.0
A18193,4,6,0,10,0.4,0.6,0.0
A18194,1,5,0,6,0.17,0.83,0.0
A18195,1,2,0,3,0.33,0.67,0.0
A18196,1,4,0,5,0.2,0.8,0.0
A18197,0,2,0,2,0.0,1.0,0.0
A18198,20,12,0,32,0.62,0.38,0.0
A18199,41,31,1,73,0.56,0.42,0.01
A18200,0,1,0,1,0.0,1.0,0.0
A18201,2,2,0,4,0.5,0.5,0.0
A18202,9,18,0,27,0.33,0.67,0.0
A18203,0,2,0,2,0.0,1.0,0.0
A18204,0,1,1,2,0.0,0.5,0.5
A18205,9,11,0,20,0.45,0.55,0.0
A18208,0,1,0,1,0.0,1.0,0.0
A18209,17,3,0,20,0.85,0.15,0.0
A18210,7,4,0,11,0.64,0.36,0.0
A18211,1,10,0,11,0.09,0.91,0.0
A18212,0,2,0,2,0.0,1.0,0.0
A18213,0,1,0,1,0.0,1.0,0.0
A18214,25,15,0,40,0.62,0.38,0.0
A18215,2,4,0,6,0.33,0.67,0.0
A18216,3,21,0,24,0.12,0.88,0.0
A18217,0,6,0,6,0.0,1.0,0.0
A18218,0,1,0,1,0.0,1.0,0.0
A18219,3,15,0,18,0.17,0.83,0.0
A18221,0,2,0,2,0.0,1.0,0.0
A18222,4,6,0,10,0.4,0.6,0.0
A18223,1,13,0,14,0.07,0.93,0.0
A18225,0,3,1,4,0.0,0.75,0.25
A18227,0,8,0,8,0.0,1.0,0.0
A18230,1,3,1,5,0.2,0.6,0.2
A18231,3,10,0,13,0.23,0.77,0.0
A18234,1,1,1,3,0.33,0.33,0.33
A18235,2,6,0,8,0.25,0.75,0.0
A18236,39,20,0,59,0.66,0.34,0.0
A18237,3,4,0,7,0.43,0.57,0.0
A18238,0,1,0,1,0.0,1.0,0.0
A18240,2,6,0,8,0.25,0.75,0.0
A18242,0,1,0,1,0.0,1.0,0.0
A18243,0,6,0,6,0.0,1.0,0.0
A18244,15,15,1,31,0.48,0.48,0.03
A18247,3,7,0,10,0.3,0.7,0.0
A18248,8,3,0,11,0.73,0.27,0.0
A18249,8,15,0,23,0.35,0.65,0.0
A18251,12,8,0,20,0.6,0.4,0.0
A18255,12,11,0,23,0.52,0.48,0.0
A18256,2,5,0,7,0.29,0.71,0.0
A18257,0,5,0,5,0.0,1.0,0.0
A18258,4,9,0,13,0.31,0.69,0.0
A18259,4,33,0,37,0.11,0.89,0.0
A18260,9,14,0,23,0.39,0.61,0.0
A18261,0,14,1,15,0.0,0.93,0.07
A18262,2,0,0,2,1.0,0.0,0.0
A18263,1,0,0,1,1.0,0.0,0.0
A18264,3,9,0,12,0.25,0.75,0.0
A18265,16,21,0,37,0.43,0.57,0.0
A18266,0,1,0,1,0.0,1.0,0.0
A18267,0,1,0,1,0.0,1.0,0.0
A18269,0,1,0,1,0.0,1.0,0.0
A18270,1,3,0,4,0.25,0.75,0.0
A18271,0,2,1,3,0.0,0.67,0.33
A18273,1,7,0,8,0.12,0.88,0.0
A18274,0,0,1,1,0.0,0.0,1.0
A18276,0,1,0,1,0.0,1.0,0.0
A18280,3,17,0,20,0.15,0.85,0.0
A18281,0,1,0,1,0.0,1.0,0.0
A18283,0,6,0,6,0.0,1.0,0.0
A18287,48,52,0,100,0.48,0.52,0.0
A18288,1,4,0,5,0.2,0.8,0.0
A18290,1,1,0,2,0.5,0.5,0.0
A18294,2,2,0,4,0.5,0.5,0.0
A18295,0,1,0,1,0.0,1.0,0.0
A18296,1,10,0,11,0.09,0.91,0.0
A18299,0,2,0,2,0.0,1.0,0.0
A18300,1,9,0,10,0.1,0.9,0.0
A18306,2,15,1,18,0.11,0.83,0.06
A18307,6,12,0,18,0.33,0.67,0.0
A18308,5,11,0,16,0.31,0.69,0.0
A18309,0,3,0,3,0.0,1.0,0.0
A18310,0,10,0,10,0.0,1.0,0.0
A18312,4,21,0,25,0.16,0.84,0.0
A18313,0,3,0,3,0.0,1.0,0.0
A18314,7,26,0,33,0.21,0.79,0.0
A18317,6,0,0,6,1.0,0.0,0.0
A18318,10,21,0,31,0.32,0.68,0.0
A18319,4,21,0,25,0.16,0.84,0.0
A18320,0,1,0,1,0.0,1.0,0.0
A18321,2,5,0,7,0.29,0.71,0.0
A18323,2,7,0,9,0.22,0.78,0.0
A18324,0,1,0,1,0.0,1.0,0.0
A18325,1,1,3,5,0.2,0.2,0.6
A18326,0,1,0,1,0.0,1.0,0.0
A18327,4,32,0,36,0.11,0.89,0.0
A18328,1,2,0,3,0.33,0.67,0.0
A18329,4,8,1,13,0.31,0.62,0.08
A18330,1,2,0,3,0.33,0.67,0.0
A18333,0,2,0,2,0.0,1.0,0.0
A18335,7,4,0,11,0.64,0.36,0.0
A18336,30,40,0,70,0.43,0.57,0.0
A18337,2,11,0,13,0.15,0.85,0.0
A18338,0,5,0,5,0.0,1.0,0.0
A18339,2,1,0,3,0.67,0.33,0.0
A18340,1,2,0,3,0.33,0.67,0.0
A18341,7,8,0,15,0.47,0.53,0.0
A18342,1,2,0,3,0.33,0.67,0.0
A18343,74,91,0,165,0.45,0.55,0.0
A18344,0,7,0,7,0.0,1.0,0.0
A18345,1,3,0,4,0.25,0.75,0.0
A18346,3,2,0,5,0.6,0.4,0.0
A18347,4,2,0,6,0.67,0.33,0.0
A18348,1,5,0,6,0.17,0.83,0.0
A18350,5,15,0,20,0.25,0.75,0.0
A18351,3,6,0,9,0.33,0.67,0.0
A18352,4,4,0,8,0.5,0.5,0.0
A18353,2,11,0,13,0.15,0.85,0.0
A18354,3,10,3,16,0.19,0.62,0.19
A18355,1,2,0,3,0.33,0.67,0.0
A18356,0,1,0,1,0.0,1.0,0.0
A18359,4,9,0,13,0.31,0.69,0.0
A18360,0,3,1,4,0.0,0.75,0.25
A18361,0,7,0,7,0.0,1.0,0.0
A18362,3,23,0,26,0.12,0.88,0.0
A18363,105,151,1,257,0.41,0.59,0.0
A18365,0,1,0,1,0.0,1.0,0.0
A18367,0,3,0,3,0.0,1.0,0.0
A18368,36,23,0,59,0.61,0.39,0.0
A18370,0,6,0,6,0.0,1.0,0.0
A18371,0,1,0,1,0.0,1.0,0.0
A18372,1,2,0,3,0.33,0.67,0.0
A18373,1,2,0,3,0.33,0.67,0.0
A18374,3,8,0,11,0.27,0.73,0.0
A18375,0,2,1,3,0.0,0.67,0.33
A18376,5,4,0,9,0.56,0.44,0.0
A18378,7,1,0,8,0.88,0.12,0.0
A18379,17,7,0,24,0.71,0.29,0.0
A18380,4,10,0,14,0.29,0.71,0.0
A18381,0,3,0,3,0.0,1.0,0.0
A18383,4,4,0,8,0.5,0.5,0.0
A18384,2,5,0,7,0.29,0.71,0.0
A18385,6,10,0,16,0.38,0.62,0.0
A18387,0,4,0,4,0.0,1.0,0.0
A18388,10,6,0,16,0.62,0.38,0.0
A18389,2,7,0,9,0.22,0.78,0.0
A18390,2,7,1,10,0.2,0.7,0.1
A18391,0,2,0,2,0.0,1.0,0.0
A18392,1,1,0,2,0.5,0.5,0.0
A18395,12,14,1,27,0.44,0.52,0.04
A18396,3,2,0,5,0.6,0.4,0.0
A18397,1,8,0,9,0.11,0.89,0.0
A18399,5,1,0,6,0.83,0.17,0.0
A18400,0,10,0,10,0.0,1.0,0.0
A18402,16,8,0,24,0.67,0.33,0.0
A18403,4,6,0,10,0.4,0.6,0.0
A18405,1,2,0,3,0.33,0.67,0.0
A18406,0,1,0,1,0.0,1.0,0.0
A18407,4,17,0,21,0.19,0.81,0.0
A18408,15,45,0,60,0.25,0.75,0.0
A18409,0,1,0,1,0.0,1.0,0.0
A18411,1,2,0,3,0.33,0.67,0.0
A18412,1,8,0,9,0.11,0.89,0.0
A18413,4,13,2,19,0.21,0.68,0.11
A18414,0,1,0,1,0.0,1.0,0.0
A18415,7,10,0,17,0.41,0.59,0.0
A18416,1,6,0,7,0.14,0.86,0.0
A18417,4,16,0,20,0.2,0.8,0.0
A18418,0,1,0,1,0.0,1.0,0.0
A18422,2,14,0,16,0.12,0.88,0.0
A18423,4,0,0,4,1.0,0.0,0.0
A18424,4,5,0,9,0.44,0.56,0.0
A18427,0,1,0,1,0.0,1.0,0.0
A18428,28,23,0,51,0.55,0.45,0.0
A18430,0,5,0,5,0.0,1.0,0.0
A18433,0,0,1,1,0.0,0.0,1.0
A18434,5,2,0,7,0.71,0.29,0.0
A18436,1,10,0,11,0.09,0.91,0.0
A18437,1,10,0,11,0.09,0.91,0.0
A18439,4,8,0,12,0.33,0.67,0.0
A18440,2,7,0,9,0.22,0.78,0.0
A18441,1,6,0,7,0.14,0.86,0.0
A18442,16,23,0,39,0.41,0.59,0.0
A18443,0,2,0,2,0.0,1.0,0.0
A18445,0,4,0,4,0.0,1.0,0.0
A18446,5,2,0,7,0.71,0.29,0.0
A18447,10,6,5,21,0.48,0.29,0.24
A18448,2,10,0,12,0.17,0.83,0.0
A18449,2,6,0,8,0.25,0.75,0.0
A18451,1,3,0,4,0.25,0.75,0.0
A18453,9,6,0,15,0.6,0.4,0.0
A18454,1,1,0,2,0.5,0.5,0.0
A18456,2,5,0,7,0.29,0.71,0.0
A18458,0,1,0,1,0.0,1.0,0.0
A18459,0,4,0,4,0.0,1.0,0.0
A18460,1,4,0,5,0.2,0.8,0.0
A18463,1,2,1,4,0.25,0.5,0.25
A18465,0,1,0,1,0.0,1.0,0.0
A18466,2,8,0,10,0.2,0.8,0.0
A18470,1,0,0,1,1.0,0.0,0.0
A18471,0,1,0,1,0.0,1.0,0.0
A18475,17,16,0,33,0.52,0.48,0.0
A18476,1,0,0,1,1.0,0.0,0.0
A18478,3,1,0,4,0.75,0.25,0.0
A18479,1,4,0,5,0.2,0.8,0.0
A18481,10,8,0,18,0.56,0.44,0.0
A18482,0,1,0,1,0.0,1.0,0.0
A18484,6,2,0,8,0.75,0.25,0.0
A18486,0,1,0,1,0.0,1.0,0.0
A18487,1,8,0,9,0.11,0.89,0.0
A18489,0,6,0,6,0.0,1.0,0.0
A18491,1,2,0,3,0.33,0.67,0.0
A18492,0,2,0,2,0.0,1.0,0.0
A18493,0,4,0,4,0.0,1.0,0.0
A18494,0,3,0,3,0.0,1.0,0.0
A18495,1,3,0,4,0.25,0.75,0.0
A18496,0,1,1,2,0.0,0.5,0.5
A18497,1,3,0,4,0.25,0.75,0.0
A18498,3,2,0,5,0.6,0.4,0.0
A18499,3,2,0,5,0.6,0.4,0.0
A18500,0,1,0,1,0.0,1.0,0.0
A18502,0,1,0,1,0.0,1.0,0.0
A18503,0,4,0,4,0.0,1.0,0.0
A18504,1,0,0,1,1.0,0.0,0.0
A18506,1,10,0,11,0.09,0.91,0.0
A18508,2,8,0,10,0.2,0.8,0.0
A18510,0,4,0,4,0.0,1.0,0.0
A18513,6,14,0,20,0.3,0.7,0.0
A18514,3,5,0,8,0.38,0.62,0.0
A18515,0,3,0,3,0.0,1.0,0.0
A18519,0,2,0,2,0.0,1.0,0.0
A18520,3,6,0,9,0.33,0.67,0.0
A18522,0,1,0,1,0.0,1.0,0.0
A18524,0,2,5,7,0.0,0.29,0.71
A18525,1,2,0,3,0.33,0.67,0.0
A18527,9,15,0,24,0.38,0.62,0.0
A18528,3,8,0,11,0.27,0.73,0.0
A18529,1,3,0,4,0.25,0.75,0.0
A18530,1,1,0,2,0.5,0.5,0.0
A18531,1,4,0,5,0.2,0.8,0.0
A18533,0,1,0,1,0.0,1.0,0.0
A18535,0,7,0,7,0.0,1.0,0.0
A18536,0,1,0,1,0.0,1.0,0.0
A18539,0,2,0,2,0.0,1.0,0.0
A18541,0,2,0,2,0.0,1.0,0.0
A18542,4,2,0,6,0.67,0.33,0.0
A18544,1,2,0,3,0.33,0.67,0.0
A18545,0,1,0,1,0.0,1.0,0.0
A18546,7,1,1,9,0.78,0.11,0.11
A18547,3,2,0,5,0.6,0.4,0.0
A18549,1,0,0,1,1.0,0.0,0.0
A18550,13,19,0,32,0.41,0.59,0.0
A18551,1,5,0,6,0.17,0.83,0.0
A18552,4,7,0,11,0.36,0.64,0.0
A18556,39,91,3,133,0.29,0.68,0.02
A18558,3,9,0,12,0.25,0.75,0.0
A18559,10,8,0,18,0.56,0.44,0.0
A18560,10,11,4,25,0.4,0.44,0.16
A18562,1,0,0,1,1.0,0.0,0.0
A18563,106,161,2,269,0.39,0.6,0.01
A18564,3,4,0,7,0.43,0.57,0.0
A18565,14,23,2,39,0.36,0.59,0.05
A18566,4,12,0,16,0.25,0.75,0.0
A18568,0,4,0,4,0.0,1.0,0.0
A18569,3,11,0,14,0.21,0.79,0.0
A18571,3,5,0,8,0.38,0.62,0.0
A18572,14,14,0,28,0.5,0.5,0.0
A18573,7,11,0,18,0.39,0.61,0.0
A18575,3,4,0,7,0.43,0.57,0.0
A18576,2,8,1,11,0.18,0.73,0.09
A18578,1,4,0,5,0.2,0.8,0.0
A18579,0,1,0,1,0.0,1.0,0.0
A18580,1,0,0,1,1.0,0.0,0.0
A18581,0,2,0,2,0.0,1.0,0.0
A18582,0,1,0,1,0.0,1.0,0.0
A18583,1,2,0,3,0.33,0.67,0.0
A18585,3,8,0,11,0.27,0.73,0.0
A18586,3,2,0,5,0.6,0.4,0.0
A18588,0,2,1,3,0.0,0.67,0.33
A18589,2,2,1,5,0.4,0.4,0.2
A18590,2,2,0,4,0.5,0.5,0.0
A18591,0,1,0,1,0.0,1.0,0.0
A18592,3,4,0,7,0.43,0.57,0.0
A18595,0,3,0,3,0.0,1.0,0.0
A18599,1,1,2,4,0.25,0.25,0.5
A18600,0,2,0,2,0.0,1.0,0.0
A18602,2,9,0,11,0.18,0.82,0.0
A18603,3,5,0,8,0.38,0.62,0.0
A18604,19,23,1,43,0.44,0.53,0.02
A18605,4,4,0,8,0.5,0.5,0.0
A18606,9,6,1,16,0.56,0.38,0.06
A18607,1,3,0,4,0.25,0.75,0.0
A18609,2,21,0,23,0.09,0.91,0.0
A18611,10,7,0,17,0.59,0.41,0.0
A18614,8,10,0,18,0.44,0.56,0.0
A18616,0,3,0,3,0.0,1.0,0.0
A18619,0,1,0,1,0.0,1.0,0.0
A18622,6,9,0,15,0.4,0.6,0.0
A18623,4,11,0,15,0.27,0.73,0.0
A18624,69,69,5,143,0.48,0.48,0.03
A18625,12,13,0,25,0.48,0.52,0.0
A18626,5,9,0,14,0.36,0.64,0.0
A18627,11,18,0,29,0.38,0.62,0.0
A18628,5,4,0,9,0.56,0.44,0.0
A18629,4,2,0,6,0.67,0.33,0.0
A18631,0,4,0,4,0.0,1.0,0.0
A18633,1,0,0,1,1.0,0.0,0.0
A18634,1,2,0,3,0.33,0.67,0.0
A18635,1,4,1,6,0.17,0.67,0.17
A18636,1,1,0,2,0.5,0.5,0.0
A18637,10,3,0,13,0.77,0.23,0.0
A18638,1,5,0,6,0.17,0.83,0.0
A18640,2,0,0,2,1.0,0.0,0.0
A18641,0,1,3,4,0.0,0.25,0.75
A18642,7,5,1,13,0.54,0.38,0.08
A18643,2,8,0,10,0.2,0.8,0.0
A18644,0,1,0,1,0.0,1.0,0.0
A18649,0,1,0,1,0.0,1.0,0.0
A18653,2,3,0,5,0.4,0.6,0.0
A18654,6,17,1,24,0.25,0.71,0.04
A18655,0,2,0,2,0.0,1.0,0.0
A18656,1,3,0,4,0.25,0.75,0.0
A18657,1,2,0,3,0.33,0.67,0.0
A18660,1,5,0,6,0.17,0.83,0.0
A18662,0,2,0,2,0.0,1.0,0.0
A18664,7,10,0,17,0.41,0.59,0.0
A18665,6,8,0,14,0.43,0.57,0.0
A18666,28,26,0,54,0.52,0.48,0.0
A18668,1,31,0,32,0.03,0.97,0.0
A18670,0,1,0,1,0.0,1.0,0.0
A18673,1,0,0,1,1.0,0.0,0.0
A18674,0,2,0,2,0.0,1.0,0.0
A18675,14,13,0,27,0.52,0.48,0.0
A18676,1,3,0,4,0.25,0.75,0.0
A18680,1,0,0,1,1.0,0.0,0.0
A18681,143,54,35,232,0.62,0.23,0.15
A18683,0,5,0,5,0.0,1.0,0.0
A18686,47,28,1,76,0.62,0.37,0.01
A18687,2,2,0,4,0.5,0.5,0.0
A18688,0,4,1,5,0.0,0.8,0.2
A18689,2,2,0,4,0.5,0.5,0.0
A18693,1,3,0,4,0.25,0.75,0.0
A18694,0,1,0,1,0.0,1.0,0.0
A18699,0,7,0,7,0.0,1.0,0.0
A18700,0,1,0,1,0.0,1.0,0.0
A18701,4,3,1,8,0.5,0.38,0.12
A18703,1,0,0,1,1.0,0.0,0.0
A18704,0,2,0,2,0.0,1.0,0.0
A18705,3,5,2,10,0.3,0.5,0.2
A18707,1,1,0,2,0.5,0.5,0.0
A18708,0,4,0,4,0.0,1.0,0.0
A18710,0,1,0,1,0.0,1.0,0.0
A18713,12,6,1,19,0.63,0.32,0.05
A18714,0,1,0,1,0.0,1.0,0.0
A18715,42,25,3,70,0.6,0.36,0.04
A18718,10,4,0,14,0.71,0.29,0.0
A18719,12,16,3,31,0.39,0.52,0.1
A18720,5,2,2,9,0.56,0.22,0.22
A18721,2,1,4,7,0.29,0.14,0.57
A18722,1,2,0,3,0.33,0.67,0.0
A18723,1,1,0,2,0.5,0.5,0.0
A18724,2,9,0,11,0.18,0.82,0.0
A18726,0,1,0,1,0.0,1.0,0.0
A18728,2,1,1,4,0.5,0.25,0.25
A18731,0,6,0,6,0.0,1.0,0.0
A18732,1,0,1,2,0.5,0.0,0.5
A18733,9,9,0,18,0.5,0.5,0.0
A18734,1,0,0,1,1.0,0.0,0.0
A18735,28,34,0,62,0.45,0.55,0.0
A18736,8,8,0,16,0.5,0.5,0.0
A18737,4,5,0,9,0.44,0.56,0.0
A18739,13,26,0,39,0.33,0.67,0.0
A18740,33,35,8,76,0.43,0.46,0.11
A18741,5,9,0,14,0.36,0.64,0.0
A18742,19,15,1,35,0.54,0.43,0.03
A18743,16,9,1,26,0.62,0.35,0.04
A18744,65,33,1,99,0.66,0.33,0.01
A18747,4,5,0,9,0.44,0.56,0.0
A18748,1,2,0,3,0.33,0.67,0.0
A18749,5,14,0,19,0.26,0.74,0.0
A18750,9,9,0,18,0.5,0.5,0.0
A18752,7,18,1,26,0.27,0.69,0.04
A18753,4,11,0,15,0.27,0.73,0.0
A18755,177,389,7,573,0.31,0.68,0.01
A18756,2,5,0,7,0.29,0.71,0.0
A18757,1,1,0,2,0.5,0.5,0.0
A18758,4,13,0,17,0.24,0.76,0.0
A18759,1,11,0,12,0.08,0.92,0.0
A18760,2,8,0,10,0.2,0.8,0.0
A18762,1,1,0,2,0.5,0.5,0.0
A18763,3,13,0,16,0.19,0.81,0.0
A18765,3,13,1,17,0.18,0.76,0.06
A18766,0,5,0,5,0.0,1.0,0.0
A18768,7,16,1,24,0.29,0.67,0.04
A18769,1,3,0,4,0.25,0.75,0.0
A18770,0,8,0,8,0.0,1.0,0.0
A18771,0,4,0,4,0.0,1.0,0.0
A18772,1,20,0,21,0.05,0.95,0.0
A18774,1,8,0,9,0.11,0.89,0.0
A18775,0,1,0,1,0.0,1.0,0.0
A18777,3,4,0,7,0.43,0.57,0.0
A18778,5,17,0,22,0.23,0.77,0.0
A18779,1,3,0,4,0.25,0.75,0.0
A18780,25,25,0,50,0.5,0.5,0.0
A18782,6,17,0,23,0.26,0.74,0.0
A18783,312,430,49,791,0.39,0.54,0.06
A18784,276,133,5,414,0.67,0.32,0.01
A18785,10,13,1,24,0.42,0.54,0.04
A18786,6,7,0,13,0.46,0.54,0.0
A18787,2,7,2,11,0.18,0.64,0.18
A18789,7,7,0,14,0.5,0.5,0.0
A18790,47,26,1,74,0.64,0.35,0.01
A18791,16,18,1,35,0.46,0.51,0.03
A18792,9,12,0,21,0.43,0.57,0.0
A18793,16,9,2,27,0.59,0.33,0.07
A18794,1,6,3,10,0.1,0.6,0.3
A18795,3,7,0,10,0.3,0.7,0.0
A18796,0,1,0,1,0.0,1.0,0.0
A18797,20,12,1,33,0.61,0.36,0.03
A18798,7,8,0,15,0.47,0.53,0.0
A18799,29,15,0,44,0.66,0.34,0.0
A18800,0,1,0,1,0.0,1.0,0.0
A18801,28,3,12,43,0.65,0.07,0.28
A18802,7,3,3,13,0.54,0.23,0.23
A18803,2,4,0,6,0.33,0.67,0.0
A18805,1,0,0,1,1.0,0.0,0.0
A18806,1,0,0,1,1.0,0.0,0.0
A18807,29,17,0,46,0.63,0.37,0.0
A18810,8,15,1,24,0.33,0.62,0.04
A18812,28,8,4,40,0.7,0.2,0.1
A18813,3,6,1,10,0.3,0.6,0.1
A18814,147,88,4,239,0.62,0.37,0.02
A18815,6,4,0,10,0.6,0.4,0.0
A18817,0,5,0,5,0.0,1.0,0.0
A18818,1,0,0,1,1.0,0.0,0.0
A18819,1,4,0,5,0.2,0.8,0.0
A18820,1,0,0,1,1.0,0.0,0.0
A18822,4,10,0,14,0.29,0.71,0.0
A18824,8,1,0,9,0.89,0.11,0.0
A18825,1,6,0,7,0.14,0.86,0.0
A18826,3,2,0,5,0.6,0.4,0.0
A18828,8,8,0,16,0.5,0.5,0.0
A18829,9,5,0,14,0.64,0.36,0.0
A18831,9,7,1,17,0.53,0.41,0.06
A18832,0,1,0,1,0.0,1.0,0.0
A18833,0,1,0,1,0.0,1.0,0.0
A18834,0,3,1,4,0.0,0.75,0.25
A18835,1,1,0,2,0.5,0.5,0.0
A18836,6,6,2,14,0.43,0.43,0.14
A18837,21,23,1,45,0.47,0.51,0.02
A18838,2,0,6,8,0.25,0.0,0.75
A18839,14,6,0,20,0.7,0.3,0.0
A18840,23,19,0,42,0.55,0.45,0.0
A18842,28,11,2,41,0.68,0.27,0.05
A18843,2,5,0,7,0.29,0.71,0.0
A18844,1,1,0,2,0.5,0.5,0.0
A18845,8,11,1,20,0.4,0.55,0.05
A18846,0,1,0,1,0.0,1.0,0.0
A18847,7,7,0,14,0.5,0.5,0.0
A18848,4,11,0,15,0.27,0.73,0.0
A18849,4,2,1,7,0.57,0.29,0.14
A18850,0,1,0,1,0.0,1.0,0.0
A18852,0,1,1,2,0.0,0.5,0.5
A18853,0,1,0,1,0.0,1.0,0.0
A18854,3,8,1,12,0.25,0.67,0.08
A18855,1,1,0,2,0.5,0.5,0.0
A18857,0,2,0,2,0.0,1.0,0.0
A18859,3,2,0,5,0.6,0.4,0.0
A18860,12,18,0,30,0.4,0.6,0.0
A18862,10,10,0,20,0.5,0.5,0.0
A18863,6,14,0,20,0.3,0.7,0.0
A18864,2,2,0,4,0.5,0.5,0.0
A18865,0,1,0,1,0.0,1.0,0.0
A18866,3,3,0,6,0.5,0.5,0.0
A18867,3,5,1,9,0.33,0.56,0.11
A18871,31,30,0,61,0.51,0.49,0.0
A18872,4,8,0,12,0.33,0.67,0.0
A18874,1,2,0,3,0.33,0.67,0.0
A18875,2,16,0,18,0.11,0.89,0.0
A18876,2,8,0,10,0.2,0.8,0.0
A18877,0,12,0,12,0.0,1.0,0.0
A18878,2,2,0,4,0.5,0.5,0.0
A18879,1,2,0,3,0.33,0.67,0.0
A18880,7,6,0,13,0.54,0.46,0.0
A18881,1,1,0,2,0.5,0.5,0.0
A18884,18,40,0,58,0.31,0.69,0.0
A18885,3,1,6,10,0.3,0.1,0.6
A18886,6,8,0,14,0.43,0.57,0.0
A18887,13,16,1,30,0.43,0.53,0.03
A18888,5,7,1,13,0.38,0.54,0.08
A18889,1,2,0,3,0.33,0.67,0.0
A18890,8,18,0,26,0.31,0.69,0.0
A18893,1,0,0,1,1.0,0.0,0.0
A18894,0,4,0,4,0.0,1.0,0.0
A18895,2,1,0,3,0.67,0.33,0.0
A18896,2,2,0,4,0.5,0.5,0.0
A18897,1,1,0,2,0.5,0.5,0.0
A18898,3,12,1,16,0.19,0.75,0.06
A18900,3,4,0,7,0.43,0.57,0.0
A18901,0,1,0,1,0.0,1.0,0.0
A18902,3,2,0,5,0.6,0.4,0.0
A18903,3,4,0,7,0.43,0.57,0.0
A18904,9,9,0,18,0.5,0.5,0.0
A18906,10,14,0,24,0.42,0.58,0.0
A18907,2,6,0,8,0.25,0.75,0.0
A18908,1,1,0,2,0.5,0.5,0.0
A18909,1,0,1,2,0.5,0.0,0.5
A18910,2,10,0,12,0.17,0.83,0.0
A18911,42,31,4,77,0.55,0.4,0.05
A18912,4,4,3,11,0.36,0.36,0.27
A18913,0,4,0,4,0.0,1.0,0.0
A18914,139,296,10,445,0.31,0.67,0.02
A18915,24,6,1,31,0.77,0.19,0.03
A18916,5,9,1,15,0.33,0.6,0.07
A18917,3,5,0,8,0.38,0.62,0.0
A18918,5,16,1,22,0.23,0.73,0.05
A18919,3,0,4,7,0.43,0.0,0.57
A18920,3,5,2,10,0.3,0.5,0.2
A18921,2,4,0,6,0.33,0.67,0.0
A18922,0,0,1,1,0.0,0.0,1.0
A18923,3,2,1,6,0.5,0.33,0.17
A18924,10,14,0,24,0.42,0.58,0.0
A18925,0,2,0,2,0.0,1.0,0.0
A18926,1,0,0,1,1.0,0.0,0.0
A18927,9,13,0,22,0.41,0.59,0.0
A18928,1,6,0,7,0.14,0.86,0.0
A18929,6,36,0,42,0.14,0.86,0.0
A18930,2,6,0,8,0.25,0.75,0.0
A18931,6,5,0,11,0.55,0.45,0.0
A18932,1,3,0,4,0.25,0.75,0.0
A18936,16,4,2,22,0.73,0.18,0.09
A18940,59,15,0,74,0.8,0.2,0.0
A18942,0,1,0,1,0.0,1.0,0.0
A18943,0,1,0,1,0.0,1.0,0.0
A18944,0,1,0,1,0.0,1.0,0.0
A18945,0,1,0,1,0.0,1.0,0.0
A18947,3,2,0,5,0.6,0.4,0.0
A18948,12,14,1,27,0.44,0.52,0.04
A18949,1,6,0,7,0.14,0.86,0.0
A18951,1,0,1,2,0.5,0.0,0.5
A18952,1,1,0,2,0.5,0.5,0.0
A18953,0,2,1,3,0.0,0.67,0.33
A18954,0,1,0,1,0.0,1.0,0.0
A18955,0,1,0,1,0.0,1.0,0.0
A18956,1,6,1,8,0.12,0.75,0.12
A18962,1,3,0,4,0.25,0.75,0.0
A18965,0,1,0,1,0.0,1.0,0.0
A18966,0,1,0,1,0.0,1.0,0.0
A18969,1,1,0,2,0.5,0.5,0.0
A18971,0,1,1,2,0.0,0.5,0.5
A18974,0,1,0,1,0.0,1.0,0.0
A18975,4,0,0,4,1.0,0.0,0.0
A18977,1,6,0,7,0.14,0.86,0.0
A18978,1,3,0,4,0.25,0.75,0.0
A18979,0,1,0,1,0.0,1.0,0.0
A18982,47,28,6,81,0.58,0.35,0.07
A18983,2,4,0,6,0.33,0.67,0.0
A18988,0,5,0,5,0.0,1.0,0.0
A18989,18,11,0,29,0.62,0.38,0.0
A18990,1,2,1,4,0.25,0.5,0.25
A18994,23,25,1,49,0.47,0.51,0.02
A18997,0,0,1,1,0.0,0.0,1.0
A18999,3,5,0,8,0.38,0.62,0.0
A19000,0,4,0,4,0.0,1.0,0.0
A19004,2,0,1,3,0.67,0.0,0.33
A19005,1,0,0,1,1.0,0.0,0.0
A19006,0,2,0,2,0.0,1.0,0.0
A19008,1,1,0,2,0.5,0.5,0.0
A19009,4,14,0,18,0.22,0.78,0.0
A19010,0,2,0,2,0.0,1.0,0.0
A19011,3,5,0,8,0.38,0.62,0.0
A19012,1,6,0,7,0.14,0.86,0.0
A19013,2,2,0,4,0.5,0.5,0.0
A19014,7,7,0,14,0.5,0.5,0.0
A19019,2,1,0,3,0.67,0.33,0.0
A19020,4,39,1,44,0.09,0.89,0.02
A19021,0,1,0,1,0.0,1.0,0.0
A19022,0,2,0,2,0.0,1.0,0.0
A19024,303,292,14,609,0.5,0.48,0.02
A19025,8,19,0,27,0.3,0.7,0.0
A19026,7,9,0,16,0.44,0.56,0.0
A19027,90,66,1,157,0.57,0.42,0.01
A19028,11,17,6,34,0.32,0.5,0.18
A19029,7,17,0,24,0.29,0.71,0.0
A19031,0,1,0,1,0.0,1.0,0.0
A19032,1,6,0,7,0.14,0.86,0.0
A19033,1,18,0,19,0.05,0.95,0.0
A19034,2,2,0,4,0.5,0.5,0.0
A19036,0,1,1,2,0.0,0.5,0.5
A19040,0,1,0,1,0.0,1.0,0.0
A19041,41,35,1,77,0.53,0.45,0.01
A19042,2,5,0,7,0.29,0.71,0.0
A19044,1,10,0,11,0.09,0.91,0.0
A19046,130,190,8,328,0.4,0.58,0.02
A19048,2,4,2,8,0.25,0.5,0.25
A19049,3,5,1,9,0.33,0.56,0.11
A19050,3,13,0,16,0.19,0.81,0.0
A19051,0,4,0,4,0.0,1.0,0.0
A19052,13,13,2,28,0.46,0.46,0.07
A19054,3,5,0,8,0.38,0.62,0.0
A19055,0,2,0,2,0.0,1.0,0.0
A19058,0,1,0,1,0.0,1.0,0.0
A19059,5,15,0,20,0.25,0.75,0.0
A19062,1,7,0,8,0.12,0.88,0.0
A19067,24,11,0,35,0.69,0.31,0.0
A19068,7,2,0,9,0.78,0.22,0.0
A19069,14,26,0,40,0.35,0.65,0.0
A19071,0,5,0,5,0.0,1.0,0.0
A19072,1,1,0,2,0.5,0.5,0.0
A19074,1,1,0,2,0.5,0.5,0.0
A19075,1,0,0,1,1.0,0.0,0.0
A19076,1,2,0,3,0.33,0.67,0.0
A19078,4,4,0,8,0.5,0.5,0.0
A19079,4,6,4,14,0.29,0.43,0.29
A19080,4,3,0,7,0.57,0.43,0.0
A19081,0,0,1,1,0.0,0.0,1.0
A19082,3,7,0,10,0.3,0.7,0.0
A19083,0,1,0,1,0.0,1.0,0.0
A19085,0,1,0,1,0.0,1.0,0.0
A19086,0,3,0,3,0.0,1.0,0.0
A19092,0,1,0,1,0.0,1.0,0.0
A19093,5,2,0,7,0.71,0.29,0.0
A19094,0,2,0,2,0.0,1.0,0.0
A19095,14,29,1,44,0.32,0.66,0.02
A19096,0,0,1,1,0.0,0.0,1.0
A19097,3,2,0,5,0.6,0.4,0.0
A19099,1,2,1,4,0.25,0.5,0.25
A19100,1,6,0,7,0.14,0.86,0.0
A19102,0,0,1,1,0.0,0.0,1.0
A19103,0,1,0,1,0.0,1.0,0.0
A19106,27,5,0,32,0.84,0.16,0.0
A19107,13,3,3,19,0.68,0.16,0.16
A19108,7,5,5,17,0.41,0.29,0.29
A19110,3,5,0,8,0.38,0.62,0.0
A19111,3,3,4,10,0.3,0.3,0.4
A19112,21,3,16,40,0.53,0.07,0.4
A19113,0,1,0,1,0.0,1.0,0.0
A19114,0,3,0,3,0.0,1.0,0.0
A19120,4,4,3,11,0.36,0.36,0.27
A19121,0,1,0,1,0.0,1.0,0.0
A19123,25,10,2,37,0.68,0.27,0.05
A19125,0,1,0,1,0.0,1.0,0.0
A19128,3,8,0,11,0.27,0.73,0.0
A19129,0,2,0,2,0.0,1.0,0.0
A19131,1,1,0,2,0.5,0.5,0.0
A19132,0,1,0,1,0.0,1.0,0.0
A19134,1,2,0,3,0.33,0.67,0.0
A19136,1,4,0,5,0.2,0.8,0.0
A19137,0,2,0,2,0.0,1.0,0.0
A19138,0,1,0,1,0.0,1.0,0.0
A19140,0,1,0,1,0.0,1.0,0.0
A19142,0,1,0,1,0.0,1.0,0.0
A19144,20,9,0,29,0.69,0.31,0.0
A19145,3,5,0,8,0.38,0.62,0.0
A19151,1,0,0,1,1.0,0.0,0.0
A19152,52,22,12,86,0.6,0.26,0.14
A19155,0,2,0,2,0.0,1.0,0.0
A19157,16,15,1,32,0.5,0.47,0.03
A19158,0,2,0,2,0.0,1.0,0.0
A19161,0,1,0,1,0.0,1.0,0.0
A19163,0,1,0,1,0.0,1.0,0.0
A19164,0,3,0,3,0.0,1.0,0.0
A19165,1,11,0,12,0.08,0.92,0.0
A19167,1,0,0,1,1.0,0.0,0.0
A19169,0,2,0,2,0.0,1.0,0.0
A19171,1,2,0,3,0.33,0.67,0.0
A19173,3,8,1,12,0.25,0.67,0.08
A19175,1,2,1,4,0.25,0.5,0.25
A19180,0,3,0,3,0.0,1.0,0.0
A19182,0,4,0,4,0.0,1.0,0.0
A19183,0,0,1,1,0.0,0.0,1.0
A19186,1,1,0,2,0.5,0.5,0.0
A19188,2,6,0,8,0.25,0.75,0.0
A19189,0,5,0,5,0.0,1.0,0.0
A19193,0,2,0,2,0.0,1.0,0.0
A19194,2,2,0,4,0.5,0.5,0.0
A19195,7,8,0,15,0.47,0.53,0.0
A19197,1,6,0,7,0.14,0.86,0.0
A19199,0,1,0,1,0.0,1.0,0.0
A19207,4,19,1,24,0.17,0.79,0.04
A19210,0,0,1,1,0.0,0.0,1.0
A19211,1,0,0,1,1.0,0.0,0.0
A19212,5,0,4,9,0.56,0.0,0.44
A19213,18,13,0,31,0.58,0.42,0.0
A19217,1,2,1,4,0.25,0.5,0.25
A19218,4,3,0,7,0.57,0.43,0.0
A19219,2,2,0,4,0.5,0.5,0.0
A19220,5,6,0,11,0.45,0.55,0.0
A19221,0,10,0,10,0.0,1.0,0.0
A19223,13,10,15,38,0.34,0.26,0.39
A19226,12,21,0,33,0.36,0.64,0.0
A19227,0,1,0,1,0.0,1.0,0.0
A19229,3,1,0,4,0.75,0.25,0.0
A19233,8,12,0,20,0.4,0.6,0.0
A19234,3,3,0,6,0.5,0.5,0.0
A19237,6,3,0,9,0.67,0.33,0.0
A19238,3,8,2,13,0.23,0.62,0.15
A19239,0,2,0,2,0.0,1.0,0.0
A19240,2,7,0,9,0.22,0.78,0.0
A19241,0,1,0,1,0.0,1.0,0.0
A19242,2,4,0,6,0.33,0.67,0.0
A19243,1,6,0,7,0.14,0.86,0.0
A19244,9,4,2,15,0.6,0.27,0.13
A19249,2,2,1,5,0.4,0.4,0.2
A19250,1,3,0,4,0.25,0.75,0.0
A19251,6,5,0,11,0.55,0.45,0.0
A19252,7,14,0,21,0.33,0.67,0.0
A19253,18,12,1,31,0.58,0.39,0.03
A19254,0,1,0,1,0.0,1.0,0.0
A19256,10,17,0,27,0.37,0.63,0.0
A19257,2,3,0,5,0.4,0.6,0.0
A19258,0,1,0,1,0.0,1.0,0.0
A19260,5,3,0,8,0.62,0.38,0.0
A19262,0,1,0,1,0.0,1.0,0.0
A19264,5,9,0,14,0.36,0.64,0.0
A19265,2,1,0,3,0.67,0.33,0.0
A19266,0,4,0,4,0.0,1.0,0.0
A19268,4,7,0,11,0.36,0.64,0.0
A19269,0,2,0,2,0.0,1.0,0.0
A19270,1,2,0,3,0.33,0.67,0.0
A19272,1,6,0,7,0.14,0.86,0.0
A19276,18,13,0,31,0.58,0.42,0.0
A19277,7,3,0,10,0.7,0.3,0.0
A19281,3,1,0,4,0.75,0.25,0.0
A19285,1,0,0,1,1.0,0.0,0.0
A19290,0,2,0,2,0.0,1.0,0.0
A19294,0,2,0,2,0.0,1.0,0.0
A19295,36,21,1,58,0.62,0.36,0.02
A19296,0,4,0,4,0.0,1.0,0.0
A19298,4,13,0,17,0.24,0.76,0.0
A19300,4,11,0,15,0.27,0.73,0.0
A19301,1,18,0,19,0.05,0.95,0.0
A19304,0,1,0,1,0.0,1.0,0.0
A19306,0,1,0,1,0.0,1.0,0.0
A19308,2,3,0,5,0.4,0.6,0.0
A19310,0,1,0,1,0.0,1.0,0.0
A19312,0,3,0,3,0.0,1.0,0.0
A19315,1,10,0,11,0.09,0.91,0.0
A19321,0,1,0,1,0.0,1.0,0.0
A19322,2,2,1,5,0.4,0.4,0.2
A19323,5,1,0,6,0.83,0.17,0.0
A19325,0,2,0,2,0.0,1.0,0.0
A19329,0,4,0,4,0.0,1.0,0.0
A19330,1,2,0,3,0.33,0.67,0.0
A19343,6,14,0,20,0.3,0.7,0.0
A19344,4,9,0,13,0.31,0.69,0.0
A19345,13,10,2,25,0.52,0.4,0.08
A19347,3,4,0,7,0.43,0.57,0.0
A19349,0,1,0,1,0.0,1.0,0.0
A19350,6,7,0,13,0.46,0.54,0.0
A19354,5,6,1,12,0.42,0.5,0.08
A19358,1,1,0,2,0.5,0.5,0.0
A19359,0,3,0,3,0.0,1.0,0.0
A19361,0,2,0,2,0.0,1.0,0.0
A19363,0,6,0,6,0.0,1.0,0.0
A19369,4,10,1,15,0.27,0.67,0.07
A19373,5,8,0,13,0.38,0.62,0.0
A19374,1,0,0,1,1.0,0.0,0.0
A19376,1,3,0,4,0.25,0.75,0.0
A19377,2,5,0,7,0.29,0.71,0.0
A19378,0,2,0,2,0.0,1.0,0.0
A19379,2,2,0,4,0.5,0.5,0.0
A19380,0,8,0,8,0.0,1.0,0.0
A19383,0,3,0,3,0.0,1.0,0.0
A19385,4,5,0,9,0.44,0.56,0.0
A19386,2,0,0,2,1.0,0.0,0.0
A19387,31,27,1,59,0.53,0.46,0.02
A19390,15,11,0,26,0.58,0.42,0.0
A19391,8,3,0,11,0.73,0.27,0.0
A19392,0,3,0,3,0.0,1.0,0.0
A19393,122,397,14,533,0.23,0.74,0.03
A19394,3,3,0,6,0.5,0.5,0.0
A19395,4,18,0,22,0.18,0.82,0.0
A19396,1,2,0,3,0.33,0.67,0.0
A19397,6,1,0,7,0.86,0.14,0.0
A19398,3,1,0,4,0.75,0.25,0.0
A19400,17,19,0,36,0.47,0.53,0.0
A19401,14,15,0,29,0.48,0.52,0.0
A19406,0,1,0,1,0.0,1.0,0.0
A19407,0,2,0,2,0.0,1.0,0.0
A19408,0,2,0,2,0.0,1.0,0.0
A19409,2,5,0,7,0.29,0.71,0.0
A19410,0,2,0,2,0.0,1.0,0.0
A19411,15,4,0,19,0.79,0.21,0.0
A19412,0,1,0,1,0.0,1.0,0.0
A19414,0,1,0,1,0.0,1.0,0.0
A19415,0,1,0,1,0.0,1.0,0.0
A19416,5,5,0,10,0.5,0.5,0.0
A19417,0,3,0,3,0.0,1.0,0.0
A19418,2,0,0,2,1.0,0.0,0.0
A19419,2,2,0,4,0.5,0.5,0.0
A19420,5,2,0,7,0.71,0.29,0.0
A19422,4,7,0,11,0.36,0.64,0.0
A19423,2,0,0,2,1.0,0.0,0.0
A19425,1,0,0,1,1.0,0.0,0.0
A19427,1,4,0,5,0.2,0.8,0.0
A19428,1,0,0,1,1.0,0.0,0.0
A19430,1,3,1,5,0.2,0.6,0.2
A19431,2,2,0,4,0.5,0.5,0.0
A19432,6,7,0,13,0.46,0.54,0.0
A19433,1,0,0,1,1.0,0.0,0.0
A19434,1,1,0,2,0.5,0.5,0.0
A19435,0,1,0,1,0.0,1.0,0.0
A19437,8,13,0,21,0.38,0.62,0.0
A19439,2,1,0,3,0.67,0.33,0.0
A19440,3,7,3,13,0.23,0.54,0.23
A19442,1,1,0,2,0.5,0.5,0.0
A19443,1,1,0,2,0.5,0.5,0.0
A19444,5,5,1,11,0.45,0.45,0.09
A19445,8,11,0,19,0.42,0.58,0.0
A19446,4,0,0,4,1.0,0.0,0.0
A19447,1,2,0,3,0.33,0.67,0.0
A19449,1,0,0,1,1.0,0.0,0.0
A19450,1,0,0,1,1.0,0.0,0.0
A19451,5,9,4,18,0.28,0.5,0.22
A19452,30,26,1,57,0.53,0.46,0.02
A19456,0,4,0,4,0.0,1.0,0.0
A19458,0,1,0,1,0.0,1.0,0.0
A19459,1,15,0,16,0.06,0.94,0.0
A19460,1,5,0,6,0.17,0.83,0.0
A19461,0,1,0,1,0.0,1.0,0.0
A19462,0,1,0,1,0.0,1.0,0.0
A19463,3,5,0,8,0.38,0.62,0.0
A19464,5,5,0,10,0.5,0.5,0.0
A19465,3,8,0,11,0.27,0.73,0.0
A19466,1,1,0,2,0.5,0.5,0.0
A19467,2,2,0,4,0.5,0.5,0.0
A19468,2,3,0,5,0.4,0.6,0.0
A19470,2,0,0,2,1.0,0.0,0.0
A19471,8,14,2,24,0.33,0.58,0.08
A19472,9,4,0,13,0.69,0.31,0.0
A19473,0,2,0,2,0.0,1.0,0.0
A19474,1,2,0,3,0.33,0.67,0.0
A19476,9,17,0,26,0.35,0.65,0.0
A19477,3,9,0,12,0.25,0.75,0.0
A19479,9,12,0,21,0.43,0.57,0.0
A19481,1,1,0,2,0.5,0.5,0.0
A19482,1,0,0,1,1.0,0.0,0.0
A19483,7,8,0,15,0.47,0.53,0.0
A19487,0,1,0,1,0.0,1.0,0.0
A19488,6,9,0,15,0.4,0.6,0.0
A19490,0,1,0,1,0.0,1.0,0.0
A19491,1,13,0,14,0.07,0.93,0.0
A19494,1,3,0,4,0.25,0.75,0.0
A19496,1,0,0,1,1.0,0.0,0.0
A19497,2,2,0,4,0.5,0.5,0.0
A19498,2,1,0,3,0.67,0.33,0.0
A19499,0,3,0,3,0.0,1.0,0.0
A19500,1,1,0,2,0.5,0.5,0.0
A19501,3,6,0,9,0.33,0.67,0.0
A19502,5,9,0,14,0.36,0.64,0.0
A19505,5,6,0,11,0.45,0.55,0.0
A19514,1,0,0,1,1.0,0.0,0.0
A19519,2,11,0,13,0.15,0.85,0.0
A19521,0,10,1,11,0.0,0.91,0.09
A19524,2,5,3,10,0.2,0.5,0.3
A19525,3,6,0,9,0.33,0.67,0.0
A19526,0,0,1,1,0.0,0.0,1.0
A19527,0,3,0,3,0.0,1.0,0.0
A19529,4,2,0,6,0.67,0.33,0.0
A19530,6,10,0,16,0.38,0.62,0.0
A19531,2,4,0,6,0.33,0.67,0.0
A19532,1,1,0,2,0.5,0.5,0.0
A19533,1,4,0,5,0.2,0.8,0.0
A19534,2,2,0,4,0.5,0.5,0.0
A19535,0,7,0,7,0.0,1.0,0.0
A19536,0,6,0,6,0.0,1.0,0.0
A19537,3,3,0,6,0.5,0.5,0.0
A19538,0,1,0,1,0.0,1.0,0.0
A19539,12,8,3,23,0.52,0.35,0.13
A19540,6,8,0,14,0.43,0.57,0.0
A19541,2,0,0,2,1.0,0.0,0.0
A19542,16,18,0,34,0.47,0.53,0.0
A19543,11,8,0,19,0.58,0.42,0.0
A19544,4,8,0,12,0.33,0.67,0.0
A19545,6,12,0,18,0.33,0.67,0.0
A19546,0,0,1,1,0.0,0.0,1.0
A19547,2,5,0,7,0.29,0.71,0.0
A19548,1,5,0,6,0.17,0.83,0.0
A19550,1,1,0,2,0.5,0.5,0.0
A19552,9,7,11,27,0.33,0.26,0.41
A19553,0,2,0,2,0.0,1.0,0.0
A19554,1,3,0,4,0.25,0.75,0.0
A19558,4,9,0,13,0.31,0.69,0.0
A19561,3,1,0,4,0.75,0.25,0.0
A19563,2,2,0,4,0.5,0.5,0.0
A19565,0,4,0,4,0.0,1.0,0.0
A19566,1,1,0,2,0.5,0.5,0.0
A19568,18,0,0,18,1.0,0.0,0.0
A19569,1,0,0,1,1.0,0.0,0.0
A19571,0,0,1,1,0.0,0.0,1.0
A19572,5,7,0,12,0.42,0.58,0.0
A19573,0,1,0,1,0.0,1.0,0.0
A19575,10,9,0,19,0.53,0.47,0.0
A19577,8,1,0,9,0.89,0.11,0.0
A19578,0,3,0,3,0.0,1.0,0.0
A19580,3,1,0,4,0.75,0.25,0.0
A19581,0,1,0,1,0.0,1.0,0.0
A19582,0,9,0,9,0.0,1.0,0.0
A19583,7,5,0,12,0.58,0.42,0.0
A19586,0,1,1,2,0.0,0.5,0.5
A19587,3,5,0,8,0.38,0.62,0.0
A19589,1,3,0,4,0.25,0.75,0.0
A19591,2,1,0,3,0.67,0.33,0.0
A19592,8,6,0,14,0.57,0.43,0.0
A19594,12,11,0,23,0.52,0.48,0.0
A19595,3,1,1,5,0.6,0.2,0.2
A19596,1,3,0,4,0.25,0.75,0.0
A19597,1,4,0,5,0.2,0.8,0.0
A19598,12,8,0,20,0.6,0.4,0.0
A19599,2,2,0,4,0.5,0.5,0.0
A19600,4,9,0,13,0.31,0.69,0.0
A19601,1,3,0,4,0.25,0.75,0.0
A19602,0,1,0,1,0.0,1.0,0.0
A19603,1,12,0,13,0.08,0.92,0.0
A19604,3,9,0,12,0.25,0.75,0.0
A19607,1,4,1,6,0.17,0.67,0.17
A19608,0,1,0,1,0.0,1.0,0.0
A19609,0,1,0,1,0.0,1.0,0.0
A19610,2,5,0,7,0.29,0.71,0.0
A19611,8,15,0,23,0.35,0.65,0.0
A19612,0,4,0,4,0.0,1.0,0.0
A19613,4,13,0,17,0.24,0.76,0.0
A19615,2,0,0,2,1.0,0.0,0.0
A19616,2,7,0,9,0.22,0.78,0.0
A19617,2,3,0,5,0.4,0.6,0.0
A19618,0,1,0,1,0.0,1.0,0.0
A19622,2,2,0,4,0.5,0.5,0.0
A19623,3,5,0,8,0.38,0.62,0.0
A19624,1,7,0,8,0.12,0.88,0.0
A19625,5,5,0,10,0.5,0.5,0.0
A19626,0,4,0,4,0.0,1.0,0.0
A19627,3,4,1,8,0.38,0.5,0.12
A19628,0,1,0,1,0.0,1.0,0.0
A19629,9,10,0,19,0.47,0.53,0.0
A19630,14,22,0,36,0.39,0.61,0.0
A19631,8,13,0,21,0.38,0.62,0.0
A19632,1,5,0,6,0.17,0.83,0.0
A19633,3,7,0,10,0.3,0.7,0.0
A19634,5,4,0,9,0.56,0.44,0.0
A19635,3,5,0,8,0.38,0.62,0.0
A19636,0,4,0,4,0.0,1.0,0.0
A19637,4,5,0,9,0.44,0.56,0.0
A19639,1,5,0,6,0.17,0.83,0.0
A19641,3,3,0,6,0.5,0.5,0.0
A19642,23,18,0,41,0.56,0.44,0.0
A19643,15,17,2,34,0.44,0.5,0.06
A19644,5,8,0,13,0.38,0.62,0.0
A19645,13,2,4,19,0.68,0.11,0.21
A19646,1,1,0,2,0.5,0.5,0.0
A19648,0,1,0,1,0.0,1.0,0.0
A19650,0,1,0,1,0.0,1.0,0.0
A19652,1,3,0,4,0.25,0.75,0.0
A19654,0,1,0,1,0.0,1.0,0.0
A19656,3,12,0,15,0.2,0.8,0.0
A19657,2,4,0,6,0.33,0.67,0.0
A19661,1,2,0,3,0.33,0.67,0.0
A19662,17,11,0,28,0.61,0.39,0.0
A19663,3,4,1,8,0.38,0.5,0.12
A19664,1,0,0,1,1.0,0.0,0.0
A19665,2,2,0,4,0.5,0.5,0.0
A19666,3,7,0,10,0.3,0.7,0.0
A19667,7,6,0,13,0.54,0.46,0.0
A19668,4,4,0,8,0.5,0.5,0.0
A19669,6,10,0,16,0.38,0.62,0.0
A19671,0,1,0,1,0.0,1.0,0.0
A19673,2,2,0,4,0.5,0.5,0.0
A19674,5,1,0,6,0.83,0.17,0.0
A19675,1,5,0,6,0.17,0.83,0.0
A19676,10,10,0,20,0.5,0.5,0.0
A19677,0,2,0,2,0.0,1.0,0.0
A19678,3,8,0,11,0.27,0.73,0.0
A19679,2,1,0,3,0.67,0.33,0.0
A19681,1,5,0,6,0.17,0.83,0.0
A19682,0,5,0,5,0.0,1.0,0.0
A19683,4,5,0,9,0.44,0.56,0.0
A19684,0,2,0,2,0.0,1.0,0.0
A19685,0,1,0,1,0.0,1.0,0.0
A19686,13,9,0,22,0.59,0.41,0.0
A19687,0,1,0,1,0.0,1.0,0.0
A19688,7,4,0,11,0.64,0.36,0.0
A19689,1,1,0,2,0.5,0.5,0.0
A19690,0,1,0,1,0.0,1.0,0.0
A19691,3,0,0,3,1.0,0.0,0.0
A19693,6,17,0,23,0.26,0.74,0.0
A19696,0,1,0,1,0.0,1.0,0.0
A19697,1,3,0,4,0.25,0.75,0.0
A19698,3,1,1,5,0.6,0.2,0.2
A19699,12,6,0,18,0.67,0.33,0.0
A19700,1,3,0,4,0.25,0.75,0.0
A19701,0,0,1,1,0.0,0.0,1.0
A19702,8,5,0,13,0.62,0.38,0.0
A19703,2,4,0,6,0.33,0.67,0.0
A19704,4,6,0,10,0.4,0.6,0.0
A19705,2,4,0,6,0.33,0.67,0.0
A19706,0,1,0,1,0.0,1.0,0.0
A19708,0,1,0,1,0.0,1.0,0.0
A19709,2,6,3,11,0.18,0.55,0.27
A19710,2,2,0,4,0.5,0.5,0.0
A19713,0,1,0,1,0.0,1.0,0.0
A19714,0,1,0,1,0.0,1.0,0.0
A19716,1,5,0,6,0.17,0.83,0.0
A19717,0,2,0,2,0.0,1.0,0.0
A19718,3,0,0,3,1.0,0.0,0.0
A19719,0,2,0,2,0.0,1.0,0.0
A19724,5,11,0,16,0.31,0.69,0.0
A19725,0,1,0,1,0.0,1.0,0.0
A19727,0,1,0,1,0.0,1.0,0.0
A19729,0,4,0,4,0.0,1.0,0.0
A19730,2,3,0,5,0.4,0.6,0.0
A19734,0,1,0,1,0.0,1.0,0.0
A19736,0,1,0,1,0.0,1.0,0.0
A19738,0,2,0,2,0.0,1.0,0.0
A19740,7,12,0,19,0.37,0.63,0.0
A19741,0,0,1,1,0.0,0.0,1.0
A19742,4,11,0,15,0.27,0.73,0.0
A19743,0,2,0,2,0.0,1.0,0.0
A19744,4,1,0,5,0.8,0.2,0.0
A19746,1,3,3,7,0.14,0.43,0.43
A19747,2,2,0,4,0.5,0.5,0.0
A19748,4,3,0,7,0.57,0.43,0.0
A19749,0,0,1,1,0.0,0.0,1.0
A19750,5,3,6,14,0.36,0.21,0.43
A19751,1,2,0,3,0.33,0.67,0.0
A19752,0,0,1,1,0.0,0.0,1.0
A19754,6,3,0,9,0.67,0.33,0.0
A19755,3,2,0,5,0.6,0.4,0.0
A19756,4,3,1,8,0.5,0.38,0.12
A19757,4,23,0,27,0.15,0.85,0.0
A19758,4,1,0,5,0.8,0.2,0.0
A19759,0,4,1,5,0.0,0.8,0.2
A19760,0,1,1,2,0.0,0.5,0.5
A19762,4,7,1,12,0.33,0.58,0.08
A19763,0,1,0,1,0.0,1.0,0.0
A19765,2,3,0,5,0.4,0.6,0.0
A19766,11,23,1,35,0.31,0.66,0.03
A19768,5,6,0,11,0.45,0.55,0.0
A19769,14,15,0,29,0.48,0.52,0.0
A19771,5,2,1,8,0.62,0.25,0.12
A19772,5,4,0,9,0.56,0.44,0.0
A19775,4,11,0,15,0.27,0.73,0.0
A19778,2,5,0,7,0.29,0.71,0.0
A19779,6,18,0,24,0.25,0.75,0.0
A19781,3,3,0,6,0.5,0.5,0.0
A19782,2,5,0,7,0.29,0.71,0.0
A19785,21,29,3,53,0.4,0.55,0.06
A19786,1,4,0,5,0.2,0.8,0.0
A19787,4,10,0,14,0.29,0.71,0.0
A19788,2,3,0,5,0.4,0.6,0.0
A19790,8,3,0,11,0.73,0.27,0.0
A19791,1,5,0,6,0.17,0.83,0.0
A19792,0,1,0,1,0.0,1.0,0.0
A19793,0,3,0,3,0.0,1.0,0.0
A19795,1,1,1,3,0.33,0.33,0.33
A19797,2,13,0,15,0.13,0.87,0.0
A19798,0,0,1,1,0.0,0.0,1.0
A19800,0,3,0,3,0.0,1.0,0.0
A19801,12,25,1,38,0.32,0.66,0.03
A19805,7,17,0,24,0.29,0.71,0.0
A19806,7,1,0,8,0.88,0.12,0.0
A19809,1,6,0,7,0.14,0.86,0.0
A19810,2,5,0,7,0.29,0.71,0.0
A19811,0,1,0,1,0.0,1.0,0.0
A19812,0,0,1,1,0.0,0.0,1.0
A19814,7,18,0,25,0.28,0.72,0.0
A19815,162,186,32,380,0.43,0.49,0.08
A19816,7,17,0,24,0.29,0.71,0.0
A19817,12,6,1,19,0.63,0.32,0.05
A19818,12,21,0,33,0.36,0.64,0.0
A19819,0,2,0,2,0.0,1.0,0.0
A19820,8,4,0,12,0.67,0.33,0.0
A19821,15,9,1,25,0.6,0.36,0.04
A19823,5,16,0,21,0.24,0.76,0.0
A19824,3,6,0,9,0.33,0.67,0.0
A19825,37,85,0,122,0.3,0.7,0.0
A19826,1,6,0,7,0.14,0.86,0.0
A19827,0,2,0,2,0.0,1.0,0.0
A19830,2,2,0,4,0.5,0.5,0.0
A19831,5,13,0,18,0.28,0.72,0.0
A19832,11,8,0,19,0.58,0.42,0.0
A19833,10,16,1,27,0.37,0.59,0.04
A19837,20,56,0,76,0.26,0.74,0.0
A19839,3,2,0,5,0.6,0.4,0.0
A19840,19,16,0,35,0.54,0.46,0.0
A19841,2,6,0,8,0.25,0.75,0.0
A19842,0,1,1,2,0.0,0.5,0.5
A19843,77,36,0,113,0.68,0.32,0.0
A19844,0,5,0,5,0.0,1.0,0.0
A19845,10,7,0,17,0.59,0.41,0.0
A19848,5,4,6,15,0.33,0.27,0.4
A19849,9,11,0,20,0.45,0.55,0.0
A19850,11,27,0,38,0.29,0.71,0.0
A19851,9,5,0,14,0.64,0.36,0.0
A19852,42,11,0,53,0.79,0.21,0.0
A19853,17,14,0,31,0.55,0.45,0.0
A19854,19,38,0,57,0.33,0.67,0.0
A19855,1,1,0,2,0.5,0.5,0.0
A19856,11,17,0,28,0.39,0.61,0.0
A19857,1,1,0,2,0.5,0.5,0.0
A19858,2,2,0,4,0.5,0.5,0.0
A19859,1,12,0,13,0.08,0.92,0.0
A19860,1,2,1,4,0.25,0.5,0.25
A19861,2,0,0,2,1.0,0.0,0.0
A19862,11,14,0,25,0.44,0.56,0.0
A19863,40,62,0,102,0.39,0.61,0.0
A19864,0,2,0,2,0.0,1.0,0.0
A19865,2,6,0,8,0.25,0.75,0.0
A19866,3,24,0,27,0.11,0.89,0.0
A19867,2,6,0,8,0.25,0.75,0.0
A19868,7,4,0,11,0.64,0.36,0.0
A19869,7,30,1,38,0.18,0.79,0.03
A19870,3,13,0,16,0.19,0.81,0.0
A19871,5,4,0,9,0.56,0.44,0.0
A19872,11,6,0,17,0.65,0.35,0.0
A19873,0,1,0,1,0.0,1.0,0.0
A19874,5,6,0,11,0.45,0.55,0.0
A19876,1,1,1,3,0.33,0.33,0.33
A19878,0,2,0,2,0.0,1.0,0.0
A19879,32,25,5,62,0.52,0.4,0.08
A19880,1,2,0,3,0.33,0.67,0.0
A19881,8,16,0,24,0.33,0.67,0.0
A19882,1,0,0,1,1.0,0.0,0.0
A19883,1,0,0,1,1.0,0.0,0.0
A19885,1,34,0,35,0.03,0.97,0.0
A19887,2,9,0,11,0.18,0.82,0.0
A19888,1,4,0,5,0.2,0.8,0.0
A19889,0,1,0,1,0.0,1.0,0.0
A19890,0,2,0,2,0.0,1.0,0.0
A19893,1,2,0,3,0.33,0.67,0.0
A19896,0,1,0,1,0.0,1.0,0.0
A19898,1,6,0,7,0.14,0.86,0.0
A19899,10,12,0,22,0.45,0.55,0.0
A19901,0,3,0,3,0.0,1.0,0.0
A19904,2,1,0,3,0.67,0.33,0.0
A19905,4,17,0,21,0.19,0.81,0.0
A19906,2,0,0,2,1.0,0.0,0.0
A19909,2,2,0,4,0.5,0.5,0.0
A19912,0,2,0,2,0.0,1.0,0.0
A19913,1,1,0,2,0.5,0.5,0.0
A19914,1,3,0,4,0.25,0.75,0.0
A19917,0,2,0,2,0.0,1.0,0.0
A19918,2,5,0,7,0.29,0.71,0.0
A19920,0,2,0,2,0.0,1.0,0.0
A19921,1,0,0,1,1.0,0.0,0.0
A19922,2,1,0,3,0.67,0.33,0.0
A19923,1,4,0,5,0.2,0.8,0.0
A19924,0,2,0,2,0.0,1.0,0.0
A19925,2,2,0,4,0.5,0.5,0.0
A19926,1,1,0,2,0.5,0.5,0.0
A19927,1,2,0,3,0.33,0.67,0.0
A19937,0,2,0,2,0.0,1.0,0.0
A19938,2,0,0,2,1.0,0.0,0.0
A19939,1,0,0,1,1.0,0.0,0.0
A19941,2,2,0,4,0.5,0.5,0.0
A19944,0,4,0,4,0.0,1.0,0.0
A19947,1,2,0,3,0.33,0.67,0.0
A19948,5,5,0,10,0.5,0.5,0.0
A19949,0,1,1,2,0.0,0.5,0.5
A19951,3,9,0,12,0.25,0.75,0.0
A19952,0,1,0,1,0.0,1.0,0.0
A19953,0,1,0,1,0.0,1.0,0.0
A19957,0,1,0,1,0.0,1.0,0.0
A19958,0,2,0,2,0.0,1.0,0.0
A19961,0,6,0,6,0.0,1.0,0.0
A19963,0,1,0,1,0.0,1.0,0.0
A19964,1,1,0,2,0.5,0.5,0.0
A19966,28,27,0,55,0.51,0.49,0.0
A19969,0,1,0,1,0.0,1.0,0.0
A19970,0,1,0,1,0.0,1.0,0.0
A19972,1,4,0,5,0.2,0.8,0.0
A19974,1,1,0,2,0.5,0.5,0.0
A19980,1,3,0,4,0.25,0.75,0.0
A19981,1,1,0,2,0.5,0.5,0.0
A19985,0,3,0,3,0.0,1.0,0.0
A19989,11,29,0,40,0.28,0.72,0.0
A19991,9,14,0,23,0.39,0.61,0.0
A19992,54,4,0,58,0.93,0.07,0.0
A19993,30,16,0,46,0.65,0.35,0.0
A19996,1,5,0,6,0.17,0.83,0.0
A19997,31,8,1,40,0.78,0.2,0.03
A19998,0,2,0,2,0.0,1.0,0.0
A19999,48,67,0,115,0.42,0.58,0.0
A20000,9,6,0,15,0.6,0.4,0.0
A20003,0,1,0,1,0.0,1.0,0.0
A20006,50,61,5,116,0.43,0.53,0.04
A20007,5,2,0,7,0.71,0.29,0.0
A20008,17,28,0,45,0.38,0.62,0.0
A20009,14,10,0,24,0.58,0.42,0.0
A20010,4,4,0,8,0.5,0.5,0.0
A20011,21,46,0,67,0.31,0.69,0.0
A20012,0,1,0,1,0.0,1.0,0.0
A20013,2,2,0,4,0.5,0.5,0.0
A20014,5,4,0,9,0.56,0.44,0.0
A20015,0,0,1,1,0.0,0.0,1.0
A20016,6,7,1,14,0.43,0.5,0.07
A20018,25,9,1,35,0.71,0.26,0.03
A20019,8,8,0,16,0.5,0.5,0.0
A20020,0,2,0,2,0.0,1.0,0.0
A20024,8,19,0,27,0.3,0.7,0.0
A20025,6,7,0,13,0.46,0.54,0.0
A20026,1,9,1,11,0.09,0.82,0.09
A20027,0,2,0,2,0.0,1.0,0.0
A20028,5,18,0,23,0.22,0.78,0.0
A20029,0,1,0,1,0.0,1.0,0.0
A20031,3,1,0,4,0.75,0.25,0.0
A20036,1,0,0,1,1.0,0.0,0.0
A20037,1,0,0,1,1.0,0.0,0.0
A20039,18,12,0,30,0.6,0.4,0.0
A20040,3,2,0,5,0.6,0.4,0.0
A20042,1,1,0,2,0.5,0.5,0.0
A20043,0,1,0,1,0.0,1.0,0.0
A20044,1,0,0,1,1.0,0.0,0.0
A20046,0,1,0,1,0.0,1.0,0.0
A20049,3,2,0,5,0.6,0.4,0.0
A20050,0,2,0,2,0.0,1.0,0.0
A20053,2,2,0,4,0.5,0.5,0.0
A20055,2,0,0,2,1.0,0.0,0.0
A20056,7,9,0,16,0.44,0.56,0.0
A20058,4,2,0,6,0.67,0.33,0.0
A20059,5,7,0,12,0.42,0.58,0.0
A20060,9,10,0,19,0.47,0.53,0.0
A20061,1,1,0,2,0.5,0.5,0.0
A20064,4,1,0,5,0.8,0.2,0.0
A20065,3,10,0,13,0.23,0.77,0.0
A20066,1,1,0,2,0.5,0.5,0.0
A20067,1,4,0,5,0.2,0.8,0.0
A20073,6,3,0,9,0.67,0.33,0.0
A20074,0,1,0,1,0.0,1.0,0.0
A20079,1,5,0,6,0.17,0.83,0.0
A20080,19,9,0,28,0.68,0.32,0.0
A20081,7,6,0,13,0.54,0.46,0.0
A20082,0,1,0,1,0.0,1.0,0.0
A20085,1,2,0,3,0.33,0.67,0.0
A20086,1,7,0,8,0.12,0.88,0.0
A20088,2,7,0,9,0.22,0.78,0.0
A20089,11,14,0,25,0.44,0.56,0.0
A20094,7,9,0,16,0.44,0.56,0.0
A20095,21,8,10,39,0.54,0.21,0.26
A20096,4,8,0,12,0.33,0.67,0.0
A20098,0,1,0,1,0.0,1.0,0.0
A20099,0,1,0,1,0.0,1.0,0.0
A20100,1,2,0,3,0.33,0.67,0.0
A20101,1,1,0,2,0.5,0.5,0.0
A20105,13,19,0,32,0.41,0.59,0.0
A20110,0,1,0,1,0.0,1.0,0.0
A20113,0,1,0,1,0.0,1.0,0.0
A20114,0,1,0,1,0.0,1.0,0.0
A20115,1,1,0,2,0.5,0.5,0.0
A20118,5,3,0,8,0.62,0.38,0.0
A20121,1,2,0,3,0.33,0.67,0.0
A20122,7,13,0,20,0.35,0.65,0.0
A20125,0,2,0,2,0.0,1.0,0.0
A20126,5,4,0,9,0.56,0.44,0.0
A20128,28,40,0,68,0.41,0.59,0.0
A20131,3,13,0,16,0.19,0.81,0.0
A20132,6,7,0,13,0.46,0.54,0.0
A20133,1,0,0,1,1.0,0.0,0.0
A20134,2,0,0,2,1.0,0.0,0.0
A20137,28,34,0,62,0.45,0.55,0.0
A20139,1,0,0,1,1.0,0.0,0.0
A20140,4,6,0,10,0.4,0.6,0.0
A20142,22,21,2,45,0.49,0.47,0.04
A20143,1,2,0,3,0.33,0.67,0.0
A20145,0,1,0,1,0.0,1.0,0.0
A20146,0,1,0,1,0.0,1.0,0.0
A20149,91,137,0,228,0.4,0.6,0.0
A20151,3,3,1,7,0.43,0.43,0.14
A20153,0,2,0,2,0.0,1.0,0.0
A20154,7,7,3,17,0.41,0.41,0.18
A20155,7,10,0,17,0.41,0.59,0.0
A20156,8,9,0,17,0.47,0.53,0.0
A20157,3,2,0,5,0.6,0.4,0.0
A20159,11,21,0,32,0.34,0.66,0.0
A20161,0,1,0,1,0.0,1.0,0.0
A20162,0,7,0,7,0.0,1.0,0.0
A20163,3,3,0,6,0.5,0.5,0.0
A20164,602,881,14,1497,0.4,0.59,0.01
A20165,5,4,2,11,0.45,0.36,0.18
A20166,15,7,0,22,0.68,0.32,0.0
A20167,35,14,7,56,0.62,0.25,0.12
A20168,32,16,0,48,0.67,0.33,0.0
A20169,5,7,0,12,0.42,0.58,0.0
A20170,0,2,0,2,0.0,1.0,0.0
A20171,11,4,2,17,0.65,0.24,0.12
A20172,0,3,0,3,0.0,1.0,0.0
A20173,4,6,0,10,0.4,0.6,0.0
A20174,11,18,0,29,0.38,0.62,0.0
A20175,4,2,0,6,0.67,0.33,0.0
A20176,3,3,2,8,0.38,0.38,0.25
A20177,1,3,0,4,0.25,0.75,0.0
A20179,5,6,0,11,0.45,0.55,0.0
A20180,2,6,0,8,0.25,0.75,0.0
A20181,2,4,3,9,0.22,0.44,0.33
A20182,0,2,0,2,0.0,1.0,0.0
A20183,4,4,0,8,0.5,0.5,0.0
A20185,18,25,0,43,0.42,0.58,0.0
A20186,0,5,0,5,0.0,1.0,0.0
A20187,1,6,0,7,0.14,0.86,0.0
A20188,1,3,0,4,0.25,0.75,0.0
A20189,133,344,2,479,0.28,0.72,0.0
A20190,3,10,0,13,0.23,0.77,0.0
A20191,0,1,0,1,0.0,1.0,0.0
A20192,37,29,0,66,0.56,0.44,0.0
A20193,21,17,0,38,0.55,0.45,0.0
A20194,2,8,0,10,0.2,0.8,0.0
A20195,18,9,0,27,0.67,0.33,0.0
A20196,6,22,0,28,0.21,0.79,0.0
A20197,0,1,0,1,0.0,1.0,0.0
A20198,4,5,0,9,0.44,0.56,0.0
A20199,3,5,0,8,0.38,0.62,0.0
A20200,0,3,0,3,0.0,1.0,0.0
A20201,4,15,1,20,0.2,0.75,0.05
A20203,2,5,0,7,0.29,0.71,0.0
A20204,20,34,0,54,0.37,0.63,0.0
A20205,3,6,0,9,0.33,0.67,0.0
A20206,1,2,0,3,0.33,0.67,0.0
A20209,0,0,1,1,0.0,0.0,1.0
A20211,588,878,21,1487,0.4,0.59,0.01
A20212,5,17,0,22,0.23,0.77,0.0
A20213,9,11,0,20,0.45,0.55,0.0
A20214,5,2,1,8,0.62,0.25,0.12
A20215,4,6,2,12,0.33,0.5,0.17
A20216,3,20,0,23,0.13,0.87,0.0
A20217,0,2,0,2,0.0,1.0,0.0
A20218,40,11,0,51,0.78,0.22,0.0
A20220,5,1,14,20,0.25,0.05,0.7
A20221,1,6,0,7,0.14,0.86,0.0
A20222,0,1,0,1,0.0,1.0,0.0
A20223,0,1,0,1,0.0,1.0,0.0
A20224,5,2,5,12,0.42,0.17,0.42
A20225,1,1,0,2,0.5,0.5,0.0
A20227,0,1,0,1,0.0,1.0,0.0
A20229,2,2,0,4,0.5,0.5,0.0
A20230,3,0,0,3,1.0,0.0,0.0
A20231,22,2,1,25,0.88,0.08,0.04
A20232,5,2,2,9,0.56,0.22,0.22
A20234,0,0,1,1,0.0,0.0,1.0
A20236,1,0,0,1,1.0,0.0,0.0
A20238,11,7,0,18,0.61,0.39,0.0
A20239,3,1,3,7,0.43,0.14,0.43
A20240,7,7,0,14,0.5,0.5,0.0
A20241,13,3,0,16,0.81,0.19,0.0
A20243,1,5,0,6,0.17,0.83,0.0
A20245,0,3,0,3,0.0,1.0,0.0
A20246,2,13,0,15,0.13,0.87,0.0
A20248,1,1,0,2,0.5,0.5,0.0
A20250,3,14,0,17,0.18,0.82,0.0
A20251,0,2,0,2,0.0,1.0,0.0
A20252,5,2,0,7,0.71,0.29,0.0
A20253,6,10,0,16,0.38,0.62,0.0
A20254,0,18,0,18,0.0,1.0,0.0
A20255,0,1,0,1,0.0,1.0,0.0
A20258,0,2,0,2,0.0,1.0,0.0
A20259,2,3,0,5,0.4,0.6,0.0
A20261,3,3,0,6,0.5,0.5,0.0
A20263,1,1,0,2,0.5,0.5,0.0
A20264,0,6,0,6,0.0,1.0,0.0
A20266,4,3,0,7,0.57,0.43,0.0
A20268,11,2,26,39,0.28,0.05,0.67
A20269,0,10,0,10,0.0,1.0,0.0
A20271,0,1,0,1,0.0,1.0,0.0
A20273,8,0,0,8,1.0,0.0,0.0
A20274,0,4,0,4,0.0,1.0,0.0
A20275,2,1,0,3,0.67,0.33,0.0
A20276,0,1,0,1,0.0,1.0,0.0
A20278,4,1,0,5,0.8,0.2,0.0
A20282,1,8,0,9,0.11,0.89,0.0
A20283,2,4,0,6,0.33,0.67,0.0
A20284,2,4,0,6,0.33,0.67,0.0
A20285,2,0,0,2,1.0,0.0,0.0
A20287,0,1,0,1,0.0,1.0,0.0
A20289,3,10,0,13,0.23,0.77,0.0
A20290,0,2,0,2,0.0,1.0,0.0
A20293,2,3,0,5,0.4,0.6,0.0
A20295,1,2,0,3,0.33,0.67,0.0
A20296,1,2,0,3,0.33,0.67,0.0
A20298,4,0,0,4,1.0,0.0,0.0
A20305,0,5,0,5,0.0,1.0,0.0
A20306,0,5,0,5,0.0,1.0,0.0
A20307,0,1,0,1,0.0,1.0,0.0
A20309,1,3,0,4,0.25,0.75,0.0
A20310,0,0,1,1,0.0,0.0,1.0
A20311,10,17,0,27,0.37,0.63,0.0
A20312,5,8,0,13,0.38,0.62,0.0
A20313,3,3,0,6,0.5,0.5,0.0
A20314,0,2,0,2,0.0,1.0,0.0
A20315,2,7,0,9,0.22,0.78,0.0
A20316,1,1,0,2,0.5,0.5,0.0
A20317,12,6,0,18,0.67,0.33,0.0
A20320,4,8,0,12,0.33,0.67,0.0
A20321,7,7,0,14,0.5,0.5,0.0
A20323,2,9,0,11,0.18,0.82,0.0
A20327,79,62,0,141,0.56,0.44,0.0
A20328,6,5,0,11,0.55,0.45,0.0
A20329,1,1,0,2,0.5,0.5,0.0
A20330,1,5,0,6,0.17,0.83,0.0
A20331,3,2,0,5,0.6,0.4,0.0
A20333,2,3,0,5,0.4,0.6,0.0
A20334,4,4,0,8,0.5,0.5,0.0
A20337,1,2,0,3,0.33,0.67,0.0
A20339,13,8,0,21,0.62,0.38,0.0
A20340,2,3,0,5,0.4,0.6,0.0
A20342,9,11,0,20,0.45,0.55,0.0
A20343,4,5,0,9,0.44,0.56,0.0
A20345,10,1,0,11,0.91,0.09,0.0
A20346,3,3,0,6,0.5,0.5,0.0
A20350,4,7,0,11,0.36,0.64,0.0
A20351,0,1,0,1,0.0,1.0,0.0
A20352,3,1,0,4,0.75,0.25,0.0
A20353,2,11,0,13,0.15,0.85,0.0
A20355,7,15,1,23,0.3,0.65,0.04
A20358,8,10,0,18,0.44,0.56,0.0
A20359,0,1,0,1,0.0,1.0,0.0
A20361,1,9,0,10,0.1,0.9,0.0
A20362,3,4,0,7,0.43,0.57,0.0
A20365,1,5,0,6,0.17,0.83,0.0
A20367,6,2,0,8,0.75,0.25,0.0
A20368,1,0,0,1,1.0,0.0,0.0
A20370,0,7,0,7,0.0,1.0,0.0
A20371,6,15,0,21,0.29,0.71,0.0
A20372,2,4,0,6,0.33,0.67,0.0
A20374,0,1,0,1,0.0,1.0,0.0
A20375,3,4,1,8,0.38,0.5,0.12
A20376,2,2,0,4,0.5,0.5,0.0
A20378,0,4,0,4,0.0,1.0,0.0
A20380,4,8,2,14,0.29,0.57,0.14
A20383,0,1,0,1,0.0,1.0,0.0
A20385,3,4,0,7,0.43,0.57,0.0
A20386,10,5,0,15,0.67,0.33,0.0
A20387,9,3,3,15,0.6,0.2,0.2
A20388,2,1,0,3,0.67,0.33,0.0
A20389,4,4,0,8,0.5,0.5,0.0
A20390,1,3,0,4,0.25,0.75,0.0
A20391,3,5,0,8,0.38,0.62,0.0
A20392,9,12,1,22,0.41,0.55,0.05
A20394,36,13,0,49,0.73,0.27,0.0
A20396,0,1,0,1,0.0,1.0,0.0
A20397,2,0,0,2,1.0,0.0,0.0
A20398,3,1,0,4,0.75,0.25,0.0
A20399,4,1,0,5,0.8,0.2,0.0
A20400,1,0,0,1,1.0,0.0,0.0
A20403,5,15,0,20,0.25,0.75,0.0
A20404,18,27,0,45,0.4,0.6,0.0
A20406,0,3,0,3,0.0,1.0,0.0
A20409,2,4,0,6,0.33,0.67,0.0
A20410,10,12,0,22,0.45,0.55,0.0
A20411,3,4,0,7,0.43,0.57,0.0
A20412,1,2,0,3,0.33,0.67,0.0
A20414,1,5,0,6,0.17,0.83,0.0
A20415,1,1,0,2,0.5,0.5,0.0
A20417,0,1,0,1,0.0,1.0,0.0
A20419,0,1,0,1,0.0,1.0,0.0
A20420,0,1,0,1,0.0,1.0,0.0
A20421,0,1,0,1,0.0,1.0,0.0
A20422,26,15,2,43,0.6,0.35,0.05
A20427,1,3,0,4,0.25,0.75,0.0
A20429,0,1,0,1,0.0,1.0,0.0
A20430,1,3,0,4,0.25,0.75,0.0
A20431,2,1,0,3,0.67,0.33,0.0
A20433,0,0,1,1,0.0,0.0,1.0
A20440,34,9,3,46,0.74,0.2,0.07
A20441,8,5,0,13,0.62,0.38,0.0
A20443,1,5,0,6,0.17,0.83,0.0
A20444,0,1,0,1,0.0,1.0,0.0
A20445,0,1,0,1,0.0,1.0,0.0
A20448,3,13,2,18,0.17,0.72,0.11
A20449,0,1,0,1,0.0,1.0,0.0
A20450,4,6,0,10,0.4,0.6,0.0
A20453,8,7,0,15,0.53,0.47,0.0
A20454,1,0,0,1,1.0,0.0,0.0
A20455,1,0,0,1,1.0,0.0,0.0
A20456,2,2,0,4,0.5,0.5,0.0
A20459,1,1,0,2,0.5,0.5,0.0
A20460,1,1,0,2,0.5,0.5,0.0
A20461,1,3,0,4,0.25,0.75,0.0
A20463,1,1,0,2,0.5,0.5,0.0
A20464,0,2,0,2,0.0,1.0,0.0
A20467,1,4,0,5,0.2,0.8,0.0
A20468,0,1,0,1,0.0,1.0,0.0
A20469,2,6,0,8,0.25,0.75,0.0
A20470,8,13,0,21,0.38,0.62,0.0
A20472,1,0,0,1,1.0,0.0,0.0
A20473,1,0,0,1,1.0,0.0,0.0
A20474,0,3,0,3,0.0,1.0,0.0
A20476,0,1,0,1,0.0,1.0,0.0
A20477,8,2,0,10,0.8,0.2,0.0
A20480,0,1,0,1,0.0,1.0,0.0
A20481,7,0,0,7,1.0,0.0,0.0
A20482,0,5,0,5,0.0,1.0,0.0
A20484,2,3,0,5,0.4,0.6,0.0
A20485,6,0,4,10,0.6,0.0,0.4
A20486,3,9,0,12,0.25,0.75,0.0
A20490,6,4,0,10,0.6,0.4,0.0
A20491,3,1,1,5,0.6,0.2,0.2
A20493,0,1,0,1,0.0,1.0,0.0
A20495,8,17,0,25,0.32,0.68,0.0
A20497,3,5,0,8,0.38,0.62,0.0
A20499,5,4,0,9,0.56,0.44,0.0
A20500,7,7,0,14,0.5,0.5,0.0
A20501,0,5,0,5,0.0,1.0,0.0
A20502,9,6,0,15,0.6,0.4,0.0
A20503,1,1,0,2,0.5,0.5,0.0
A20504,0,1,0,1,0.0,1.0,0.0
A20505,1,0,0,1,1.0,0.0,0.0
A20506,1,1,0,2,0.5,0.5,0.0
A20507,1,0,0,1,1.0,0.0,0.0
A20508,1,0,0,1,1.0,0.0,0.0
A20509,1,2,0,3,0.33,0.67,0.0
A20510,0,2,0,2,0.0,1.0,0.0
A20514,0,3,0,3,0.0,1.0,0.0
A20520,1,4,0,5,0.2,0.8,0.0
A20521,0,2,0,2,0.0,1.0,0.0
A20522,0,1,0,1,0.0,1.0,0.0
A20523,2,3,0,5,0.4,0.6,0.0
A20524,43,35,1,79,0.54,0.44,0.01
A20525,1,3,0,4,0.25,0.75,0.0
A20526,0,1,0,1,0.0,1.0,0.0
A20530,13,20,0,33,0.39,0.61,0.0
A20531,19,9,0,28,0.68,0.32,0.0
A20532,2,2,0,4,0.5,0.5,0.0
A20533,9,4,0,13,0.69,0.31,0.0
A20535,3,1,0,4,0.75,0.25,0.0
A20536,2,1,0,3,0.67,0.33,0.0
A20537,0,1,0,1,0.0,1.0,0.0
A20538,3,2,0,5,0.6,0.4,0.0
A20539,0,3,0,3,0.0,1.0,0.0
A20540,1,2,0,3,0.33,0.67,0.0
A20541,0,3,0,3,0.0,1.0,0.0
A20542,1,3,0,4,0.25,0.75,0.0
A20543,0,7,0,7,0.0,1.0,0.0
A20544,2,4,0,6,0.33,0.67,0.0
A20545,0,1,0,1,0.0,1.0,0.0
A20546,0,3,0,3,0.0,1.0,0.0
A20547,1,4,0,5,0.2,0.8,0.0
A20548,0,2,4,6,0.0,0.33,0.67
A20549,0,1,0,1,0.0,1.0,0.0
A20550,0,1,0,1,0.0,1.0,0.0
A20551,2,8,0,10,0.2,0.8,0.0
A20552,0,4,0,4,0.0,1.0,0.0
A20553,0,3,0,3,0.0,1.0,0.0
A20554,0,1,0,1,0.0,1.0,0.0
A20555,1,1,0,2,0.5,0.5,0.0
A20556,2,3,0,5,0.4,0.6,0.0
A20557,1,2,0,3,0.33,0.67,0.0
A20558,2,6,0,8,0.25,0.75,0.0
A20559,0,2,0,2,0.0,1.0,0.0
A20560,0,1,0,1,0.0,1.0,0.0
A20561,0,1,0,1,0.0,1.0,0.0
A20562,0,2,0,2,0.0,1.0,0.0
A20563,0,1,0,1,0.0,1.0,0.0
A20564,0,1,0,1,0.0,1.0,0.0
A20565,1,3,0,4,0.25,0.75,0.0
A20566,1,3,0,4,0.25,0.75,0.0
A20567,0,1,0,1,0.0,1.0,0.0
A20568,1,3,0,4,0.25,0.75,0.0
A20569,0,1,0,1,0.0,1.0,0.0
A20570,2,2,0,4,0.5,0.5,0.0
A20571,2,3,0,5,0.4,0.6,0.0
A20572,4,6,1,11,0.36,0.55,0.09
A20573,0,1,0,1,0.0,1.0,0.0
A20574,0,1,0,1,0.0,1.0,0.0
A20575,0,2,0,2,0.0,1.0,0.0
A20576,0,1,0,1,0.0,1.0,0.0
A20577,25,32,0,57,0.44,0.56,0.0
A20578,3,5,0,8,0.38,0.62,0.0
A20579,0,1,0,1,0.0,1.0,0.0
A20580,0,1,0,1,0.0,1.0,0.0
A20581,1,1,0,2,0.5,0.5,0.0
A20582,2,2,0,4,0.5,0.5,0.0
A20583,27,32,0,59,0.46,0.54,0.0
A20584,0,3,0,3,0.0,1.0,0.0
A20585,1,7,0,8,0.12,0.88,0.0
A20586,0,1,0,1,0.0,1.0,0.0
A20587,0,1,0,1,0.0,1.0,0.0
A20588,1,2,0,3,0.33,0.67,0.0
A20589,5,2,0,7,0.71,0.29,0.0
A20590,41,23,0,64,0.64,0.36,0.0
A20591,4,2,0,6,0.67,0.33,0.0
A20592,5,6,0,11,0.45,0.55,0.0
A20593,0,1,0,1,0.0,1.0,0.0
A20594,0,1,0,1,0.0,1.0,0.0
A20595,0,2,0,2,0.0,1.0,0.0
A20596,1,3,0,4,0.25,0.75,0.0
A20597,1,4,0,5,0.2,0.8,0.0
A20598,0,2,0,2,0.0,1.0,0.0
A20602,1,0,0,1,1.0,0.0,0.0
A20605,1,1,0,2,0.5,0.5,0.0
A20606,18,13,0,31,0.58,0.42,0.0
A20607,1,5,0,6,0.17,0.83,0.0
A20608,8,1,0,9,0.89,0.11,0.0
A20609,13,14,0,27,0.48,0.52,0.0
A20612,3,6,0,9,0.33,0.67,0.0
A20613,1,3,0,4,0.25,0.75,0.0
A20616,1,1,0,2,0.5,0.5,0.0
A20618,0,1,0,1,0.0,1.0,0.0
A20619,17,16,0,33,0.52,0.48,0.0
A20621,4,19,0,23,0.17,0.83,0.0
A20625,1,0,0,1,1.0,0.0,0.0
A20627,15,9,0,24,0.62,0.38,0.0
A20628,2,1,0,3,0.67,0.33,0.0
A20629,2,2,0,4,0.5,0.5,0.0
A20631,0,1,0,1,0.0,1.0,0.0
A20633,0,1,0,1,0.0,1.0,0.0
A20634,3,4,0,7,0.43,0.57,0.0
A20637,1,2,0,3,0.33,0.67,0.0
A20639,13,14,0,27,0.48,0.52,0.0
A20640,2,1,0,3,0.67,0.33,0.0
A20641,1,9,0,10,0.1,0.9,0.0
A20645,0,8,0,8,0.0,1.0,0.0
A20647,0,2,2,4,0.0,0.5,0.5
A20649,17,7,0,24,0.71,0.29,0.0
A20650,3,1,0,4,0.75,0.25,0.0
A20654,0,2,0,2,0.0,1.0,0.0
A20655,3,5,0,8,0.38,0.62,0.0
A20656,2,0,0,2,1.0,0.0,0.0
A20657,0,1,0,1,0.0,1.0,0.0
A20661,0,1,0,1,0.0,1.0,0.0
A20662,0,2,0,2,0.0,1.0,0.0
A20664,0,3,0,3,0.0,1.0,0.0
A20665,1,11,0,12,0.08,0.92,0.0
A20667,0,1,0,1,0.0,1.0,0.0
A20668,0,3,0,3,0.0,1.0,0.0
A20669,0,1,0,1,0.0,1.0,0.0
A20670,0,1,0,1,0.0,1.0,0.0
A20671,3,3,0,6,0.5,0.5,0.0
A20672,0,1,0,1,0.0,1.0,0.0
A20675,0,1,0,1,0.0,1.0,0.0
A20676,0,3,0,3,0.0,1.0,0.0
A20677,0,2,0,2,0.0,1.0,0.0
A20678,5,10,0,15,0.33,0.67,0.0
A20679,1,1,0,2,0.5,0.5,0.0
A20680,0,1,0,1,0.0,1.0,0.0
A20682,0,3,0,3,0.0,1.0,0.0
A20684,0,1,0,1,0.0,1.0,0.0
A20686,1,3,0,4,0.25,0.75,0.0
A20688,1,0,0,1,1.0,0.0,0.0
A20690,1,0,2,3,0.33,0.0,0.67
A20691,4,2,2,8,0.5,0.25,0.25
A20693,0,2,0,2,0.0,1.0,0.0
A20695,4,7,0,11,0.36,0.64,0.0
A20698,0,1,0,1,0.0,1.0,0.0
A20699,1,4,0,5,0.2,0.8,0.0
A20702,1,0,1,2,0.5,0.0,0.5
A20703,0,2,0,2,0.0,1.0,0.0
A20704,6,3,0,9,0.67,0.33,0.0
A20705,3,5,0,8,0.38,0.62,0.0
A20706,2,5,0,7,0.29,0.71,0.0
A20707,3,6,0,9,0.33,0.67,0.0
A20708,0,4,0,4,0.0,1.0,0.0
A20710,0,2,0,2,0.0,1.0,0.0
A20711,1,1,0,2,0.5,0.5,0.0
A20712,0,2,0,2,0.0,1.0,0.0
A20713,5,13,0,18,0.28,0.72,0.0
A20714,1,3,1,5,0.2,0.6,0.2
A20715,0,1,0,1,0.0,1.0,0.0
A20716,4,3,0,7,0.57,0.43,0.0
A20722,2,2,0,4,0.5,0.5,0.0
A20723,0,2,0,2,0.0,1.0,0.0
A20724,10,8,1,19,0.53,0.42,0.05
A20726,0,2,0,2,0.0,1.0,0.0
A20730,0,2,0,2,0.0,1.0,0.0
A20731,0,1,0,1,0.0,1.0,0.0
A20732,6,2,0,8,0.75,0.25,0.0
A20733,4,4,0,8,0.5,0.5,0.0
A20734,5,6,1,12,0.42,0.5,0.08
A20735,0,1,0,1,0.0,1.0,0.0
A20736,0,2,0,2,0.0,1.0,0.0
A20737,0,1,0,1,0.0,1.0,0.0
A20738,0,1,0,1,0.0,1.0,0.0
A20739,1,1,0,2,0.5,0.5,0.0
A20740,1,1,0,2,0.5,0.5,0.0
A20741,0,1,0,1,0.0,1.0,0.0
A20742,0,2,0,2,0.0,1.0,0.0
A20743,1,5,0,6,0.17,0.83,0.0
A20744,0,1,0,1,0.0,1.0,0.0
A20745,2,1,0,3,0.67,0.33,0.0
A20746,1,9,1,11,0.09,0.82,0.09
A20747,0,1,0,1,0.0,1.0,0.0
A20748,15,18,0,33,0.45,0.55,0.0
A20749,4,4,0,8,0.5,0.5,0.0
A20750,0,1,0,1,0.0,1.0,0.0
A20751,3,2,0,5,0.6,0.4,0.0
A20752,4,1,0,5,0.8,0.2,0.0
A20753,15,14,4,33,0.45,0.42,0.12
A20754,1,1,0,2,0.5,0.5,0.0
A20755,4,2,0,6,0.67,0.33,0.0
A20756,0,1,0,1,0.0,1.0,0.0
A20757,1,1,0,2,0.5,0.5,0.0
A20758,0,5,0,5,0.0,1.0,0.0
A20759,3,2,0,5,0.6,0.4,0.0
A20760,0,1,0,1,0.0,1.0,0.0
A20761,9,8,0,17,0.53,0.47,0.0
A20762,0,2,0,2,0.0,1.0,0.0
A20763,0,1,0,1,0.0,1.0,0.0
A20764,0,1,0,1,0.0,1.0,0.0
A20765,3,3,0,6,0.5,0.5,0.0
A20766,11,9,0,20,0.55,0.45,0.0
A20767,0,1,0,1,0.0,1.0,0.0
A20768,0,1,0,1,0.0,1.0,0.0
A20769,0,1,0,1,0.0,1.0,0.0
A20770,0,3,0,3,0.0,1.0,0.0
A20771,0,3,0,3,0.0,1.0,0.0
A20772,4,3,0,7,0.57,0.43,0.0
A20773,0,5,0,5,0.0,1.0,0.0
A20774,0,1,0,1,0.0,1.0,0.0
A20775,0,1,0,1,0.0,1.0,0.0
A20776,1,1,0,2,0.5,0.5,0.0
A20777,0,1,0,1,0.0,1.0,0.0
A20778,0,1,0,1,0.0,1.0,0.0
A20779,1,4,0,5,0.2,0.8,0.0
A20780,0,2,0,2,0.0,1.0,0.0
A20781,0,1,0,1,0.0,1.0,0.0
A20782,0,1,0,1,0.0,1.0,0.0
A20783,0,1,0,1,0.0,1.0,0.0
A20784,0,1,0,1,0.0,1.0,0.0
A20785,0,1,0,1,0.0,1.0,0.0
A20786,0,1,0,1,0.0,1.0,0.0
A20787,2,3,0,5,0.4,0.6,0.0
A20788,1,1,0,2,0.5,0.5,0.0
A20789,0,2,0,2,0.0,1.0,0.0
A20790,2,3,0,5,0.4,0.6,0.0
A20791,0,1,0,1,0.0,1.0,0.0
A20792,0,1,0,1,0.0,1.0,0.0
A20793,1,2,0,3,0.33,0.67,0.0
A20794,1,1,0,2,0.5,0.5,0.0
A20795,4,7,0,11,0.36,0.64,0.0
A20796,0,1,0,1,0.0,1.0,0.0
A20797,0,3,0,3,0.0,1.0,0.0
A20798,5,9,0,14,0.36,0.64,0.0
A20799,0,1,0,1,0.0,1.0,0.0
A20800,0,1,0,1,0.0,1.0,0.0
A20801,2,5,0,7,0.29,0.71,0.0
A20802,21,15,0,36,0.58,0.42,0.0
A20803,2,2,0,4,0.5,0.5,0.0
A20804,0,1,0,1,0.0,1.0,0.0
A20805,1,1,0,2,0.5,0.5,0.0
A20806,0,1,0,1,0.0,1.0,0.0
A20807,0,5,0,5,0.0,1.0,0.0
A20808,1,1,0,2,0.5,0.5,0.0
A20809,0,1,0,1,0.0,1.0,0.0
A20810,0,1,0,1,0.0,1.0,0.0
A20811,0,2,0,2,0.0,1.0,0.0
A20812,0,1,0,1,0.0,1.0,0.0
A20813,4,7,0,11,0.36,0.64,0.0
A20814,0,1,0,1,0.0,1.0,0.0
A20815,0,1,0,1,0.0,1.0,0.0
A20816,2,1,0,3,0.67,0.33,0.0
A20817,0,3,0,3,0.0,1.0,0.0
A20818,1,2,1,4,0.25,0.5,0.25
A20819,6,4,3,13,0.46,0.31,0.23
A20820,25,9,0,34,0.74,0.26,0.0
A20821,1,1,0,2,0.5,0.5,0.0
A20822,0,2,0,2,0.0,1.0,0.0
A20823,0,14,0,14,0.0,1.0,0.0
A20824,0,1,0,1,0.0,1.0,0.0
A20825,0,1,0,1,0.0,1.0,0.0
A20826,8,11,1,20,0.4,0.55,0.05
A20827,3,1,0,4,0.75,0.25,0.0
A20828,2,2,0,4,0.5,0.5,0.0
A20829,0,1,0,1,0.0,1.0,0.0
A20830,4,3,0,7,0.57,0.43,0.0
A20831,0,1,0,1,0.0,1.0,0.0
A20832,0,1,0,1,0.0,1.0,0.0
A20833,0,1,0,1,0.0,1.0,0.0
A20834,2,3,1,6,0.33,0.5,0.17
A20835,0,3,0,3,0.0,1.0,0.0
A20836,4,6,4,14,0.29,0.43,0.29
A20837,0,1,0,1,0.0,1.0,0.0
A20838,7,5,0,12,0.58,0.42,0.0
A20839,2,2,0,4,0.5,0.5,0.0
A20840,3,1,0,4,0.75,0.25,0.0
A20841,13,14,0,27,0.48,0.52,0.0
A20842,1,4,0,5,0.2,0.8,0.0
A20843,1,1,0,2,0.5,0.5,0.0
A20844,1,1,0,2,0.5,0.5,0.0
A20845,1,2,0,3,0.33,0.67,0.0
A20846,1,1,0,2,0.5,0.5,0.0
A20847,0,2,0,2,0.0,1.0,0.0
A20848,0,1,0,1,0.0,1.0,0.0
A20849,1,1,0,2,0.5,0.5,0.0
A20850,1,3,2,6,0.17,0.5,0.33
A20851,0,1,0,1,0.0,1.0,0.0
A20852,0,2,0,2,0.0,1.0,0.0
A20853,0,2,0,2,0.0,1.0,0.0
A20854,3,1,0,4,0.75,0.25,0.0
A20855,0,3,0,3,0.0,1.0,0.0
A20856,0,2,0,2,0.0,1.0,0.0
A20857,0,1,0,1,0.0,1.0,0.0
A20858,0,1,0,1,0.0,1.0,0.0
A20859,1,1,0,2,0.5,0.5,0.0
A20860,2,6,0,8,0.25,0.75,0.0
A20861,2,1,0,3,0.67,0.33,0.0
A20862,0,1,0,1,0.0,1.0,0.0
A20863,1,3,0,4,0.25,0.75,0.0
A20864,0,3,0,3,0.0,1.0,0.0
A20865,0,1,0,1,0.0,1.0,0.0
A20866,0,1,0,1,0.0,1.0,0.0
A20867,0,1,0,1,0.0,1.0,0.0
A20868,0,2,0,2,0.0,1.0,0.0
A20869,0,2,0,2,0.0,1.0,0.0
A20870,0,1,0,1,0.0,1.0,0.0
A20871,1,1,0,2,0.5,0.5,0.0
A20872,1,1,0,2,0.5,0.5,0.0
A20873,1,1,0,2,0.5,0.5,0.0
A20874,1,2,0,3,0.33,0.67,0.0
A20875,4,1,0,5,0.8,0.2,0.0
A20876,7,16,0,23,0.3,0.7,0.0
A20877,0,1,0,1,0.0,1.0,0.0
A20878,0,1,0,1,0.0,1.0,0.0
A20879,0,2,0,2,0.0,1.0,0.0
A20880,0,1,0,1,0.0,1.0,0.0
A20881,0,2,0,2,0.0,1.0,0.0
A20882,0,8,0,8,0.0,1.0,0.0
A20883,2,2,0,4,0.5,0.5,0.0
A20884,0,2,1,3,0.0,0.67,0.33
A20885,1,1,0,2,0.5,0.5,0.0
A20886,0,1,0,1,0.0,1.0,0.0
A20887,0,3,1,4,0.0,0.75,0.25
A20888,31,20,0,51,0.61,0.39,0.0
A20889,0,3,0,3,0.0,1.0,0.0
A20890,1,1,0,2,0.5,0.5,0.0
A20891,0,3,0,3,0.0,1.0,0.0
A20892,5,9,0,14,0.36,0.64,0.0
A20893,4,1,0,5,0.8,0.2,0.0
A20894,1,1,0,2,0.5,0.5,0.0
A20895,2,5,0,7,0.29,0.71,0.0
A20896,5,11,0,16,0.31,0.69,0.0
A20897,2,1,0,3,0.67,0.33,0.0
A20898,1,6,0,7,0.14,0.86,0.0
A20899,0,1,0,1,0.0,1.0,0.0
A20900,0,1,0,1,0.0,1.0,0.0
A20901,5,4,0,9,0.56,0.44,0.0
A20902,5,8,0,13,0.38,0.62,0.0
A20903,0,1,0,1,0.0,1.0,0.0
A20904,0,2,0,2,0.0,1.0,0.0
A20905,2,9,0,11,0.18,0.82,0.0
A20906,0,5,0,5,0.0,1.0,0.0
A20907,0,1,0,1,0.0,1.0,0.0
A20908,16,7,0,23,0.7,0.3,0.0
A20909,0,3,0,3,0.0,1.0,0.0
A20910,0,1,0,1,0.0,1.0,0.0
A20911,0,1,0,1,0.0,1.0,0.0
A20912,4,5,0,9,0.44,0.56,0.0
A20913,3,8,0,11,0.27,0.73,0.0
A20914,0,1,0,1,0.0,1.0,0.0
A20915,0,4,2,6,0.0,0.67,0.33
A20916,1,2,0,3,0.33,0.67,0.0
A20917,0,1,0,1,0.0,1.0,0.0
A20918,0,1,0,1,0.0,1.0,0.0
A20919,1,10,0,11,0.09,0.91,0.0
A20920,2,4,0,6,0.33,0.67,0.0
A20921,0,1,0,1,0.0,1.0,0.0
A20922,53,172,2,227,0.23,0.76,0.01
A20923,2,3,0,5,0.4,0.6,0.0
A20924,0,1,0,1,0.0,1.0,0.0
A20925,3,5,0,8,0.38,0.62,0.0
A20926,0,1,0,1,0.0,1.0,0.0
A20927,3,2,0,5,0.6,0.4,0.0
A20928,0,1,0,1,0.0,1.0,0.0
A20929,0,1,0,1,0.0,1.0,0.0
A20930,1,1,0,2,0.5,0.5,0.0
A20931,0,4,0,4,0.0,1.0,0.0
A20932,2,1,0,3,0.67,0.33,0.0
A20933,2,5,0,7,0.29,0.71,0.0
A20934,0,1,0,1,0.0,1.0,0.0
A20935,1,1,0,2,0.5,0.5,0.0
A20936,0,1,0,1,0.0,1.0,0.0
A20937,0,3,0,3,0.0,1.0,0.0
A20938,0,1,0,1,0.0,1.0,0.0
A20939,4,6,0,10,0.4,0.6,0.0
A20940,2,6,0,8,0.25,0.75,0.0
A20941,3,4,0,7,0.43,0.57,0.0
A20942,1,3,0,4,0.25,0.75,0.0
A20943,15,9,0,24,0.62,0.38,0.0
A20944,2,9,0,11,0.18,0.82,0.0
A20945,0,2,0,2,0.0,1.0,0.0
A20946,0,1,0,1,0.0,1.0,0.0
A20947,3,1,0,4,0.75,0.25,0.0
A20948,0,1,0,1,0.0,1.0,0.0
A20949,7,4,0,11,0.64,0.36,0.0
A20950,7,4,0,11,0.64,0.36,0.0
A20951,0,1,0,1,0.0,1.0,0.0
A20952,1,4,1,6,0.17,0.67,0.17
A20953,0,3,3,6,0.0,0.5,0.5
A20954,0,1,0,1,0.0,1.0,0.0
A20955,0,4,1,5,0.0,0.8,0.2
A20956,1,1,0,2,0.5,0.5,0.0
A20957,0,2,0,2,0.0,1.0,0.0
A20958,1,7,0,8,0.12,0.88,0.0
A20959,0,1,0,1,0.0,1.0,0.0
A20961,1,1,0,2,0.5,0.5,0.0
A20962,39,7,3,49,0.8,0.14,0.06
A20963,4,7,1,12,0.33,0.58,0.08
